11303321023103320320
2 3 1 2 2 2 2 1 1 3 3 2 0 0 3 3 0 2 1 2
1 2 2 3 2 3 0 1 2 3 0 1 1 3 1 1 3 1 0 0
00001012311113302122
0  0  2  0  0  2  0  2  3  3  1  0  2  2  3  3  0  1  1  0
3  2  2  1  2  3  1  3  2  2  2  2  3  3  0  0  1  0  0  0
3 3 3 2 3 3 1 0 2 1 0 3 2 2 2 0 0 1 1 2
00112102233002212302
3 3 0 3 0 0 1 3 1 0 0 2 0 2 0 3 2 2 1 2
0  3  3  1  3  0  0  0  3  1  3  1  0  3  1  0  3  1  0  2
23323332312110211030
2  0  0  0  0  1  0  1  3  1  0  0  1  2  0  3  0  0  2  0
0 0 0 0 2 2 1 1 3 3 2 3 1 0 0 3 2 0 2 2
30203113023012003020
21111022103302001210
0 0 3 3 1 3 1 1 0 2 2 2 0 0 3 1 2 0 0 2
2  0  0  3  3  0  1  1  0  2  1  1  1  3  3  1  1  3  0  0
22021332032210123330
3 0 1 1 2 2 1 3 2 2 3 3 2 0 0 1 1 2 2 2
2  0  2  1  2  2  1  3  3  3  1  1  2  1  0  0  1  2  1  0
00001122213132220102
0  0  3  0  0  3  0  2  2  0  0  1  1  2  2  0  1  1  0  0
3  3  0  3  0  1  2  2  1  1  3  1  1  2  2  2  3  0  0  2
1 1 0 1 0 1 0 0 1 1 0 1 0 0 1 1 0 0 1 0
