0  3  0  2  0  2  3  3  3  2  0  0  2  0  2  1  3  2  1  0  0  3  1  3  0  3  2  1  0  2  1  2  1  0  2  2  2
3 2 2 0 3 1 0 1 0 0 3 3 2 0 3 2 1 1 0 0 0 0 0 0 1 3 2 1 2 3 2 1 1 0 1 3 2
3012331300030312133030211331010002312
2 1 1 2 0 0 0 0 2 3 0 2 2 2 1 2 1 0 1 1 1 1 2 3 1 3 3 3 0 2 2 1 1 3 3 3 2
3 0 1 2 1 0 1 0 3 1 0 0 3 1 0 3 2 2 1 2 3 1 1 0 3 2 2 3 1 1 0 0 0 2 3 2 0
0  3  1  3  0  3  2  1  0  1  1  3  2  2  3  1  1  0  0  3  3  1  2  2  0  3  3  1  0  0  3  2  1  2  1  2  2
2  1  3  3  3  1  2  3  3  3  3  0  0  0  2  1  1  1  3  3  0  1  2  3  2  3  2  0  1  2  2  3  3  0  0  1  2
3033230022220200302203023123212312200
0002133312102102002302220200010032002
3 1 2 3 0 2 2 3 3 2 2 0 1 3 0 3 1 1 1 3 3 3 1 3 2 1 2 1 3 3 2 3 2 3 3 0 0
3 0 1 3 3 2 3 3 3 2 0 2 2 0 2 0 1 0 2 2 0 0 0 1 3 2 0 1 0 0 0 1 3 1 0 2 2
1022223112130002203221333113311321312
1  2  1  2  1  3  0  2  2  0  3  3  1  0  3  2  3  1  3  0  3  0  0  0  1  1  3  3  3  2  1  0  1  3  2  0  2
3 1 2 3 2 0 1 3 3 0 3 3 3 3 2 0 0 3 1 0 2 2 0 2 3 0 0 1 3 1 3 1 2 0 1 1 0
2213121023332022312131011012022311330
2 1 2 0 0 0 0 1 3 3 2 3 3 1 2 2 1 0 3 2 0 0 0 2 0 2 3 3 1 3 3 2 2 0 1 0 0
0130103212333123011132201311111233120
1  0  0  2  0  0  1  2  1  2  3  1  2  2  1  0  1  2  2  2  2  3  0  2  2  0  3  0  0  1  3  2  0  1  0  2  2
0233211222013310103221231313213113032
0  2  1  2  1  2  0  0  3  1  2  0  2  1  3  3  1  2  1  1  3  3  2  0  3  0  3  3  2  2  2  2  3  3  2  3  2
1 3 1 3 1 0 0 0 2 2 1 3 3 3 1 1 2 3 0 1 3 0 2 2 2 0 1 2 3 1 0 1 0 1 3 0 0
2 3 3 3 0 2 1 1 0 2 3 0 2 1 2 2 2 3 2 0 2 1 2 1 1 0 1 1 1 3 2 3 3 1 2 1 2
3320113130310001120130231113013320232
1320203330033131202001113031212002002
1 3 0 3 1 3 2 1 2 2 0 2 2 3 0 2 3 2 3 2 1 3 2 2 1 1 2 0 3 3 2 2 3 0 3 3 0
0  1  0  0  1  0  0  0  0  1  0  0  0  1  1  0  0  0  0  0  0  1  1  1  0  0  0  1  0  1  1  0  1  1  1  0  0
