2033013001020312012201032030012200030200
2133313011203001301101221130230030033302
0 2 0 3 1 0 3 3 2 0 3 1 1 3 2 1 2 0 0 0 2 2 1 1 2 0 1 2 0 3 3 0 3 3 2 3 1 0 1 0
3 3 1 1 1 2 2 0 2 3 0 2 3 0 0 3 0 1 1 1 0 1 1 1 1 2 3 0 3 3 0 1 1 0 2 0 2 0 0 2
0022320321313002320233012031122131031020
0 0 2 0 0 2 1 1 2 1 0 3 3 0 0 2 3 1 2 1 3 3 3 2 0 0 3 3 3 2 3 2 3 1 0 3 2 0 3 2
2230103310333222121030321313323202310212
3 0 2 2 1 3 3 0 0 1 2 2 0 1 0 0 2 0 3 0 0 0 2 2 2 2 0 1 2 0 0 0 3 3 1 3 1 1 3 0
2  2  2  2  1  1  2  0  3  2  2  2  1  1  1  2  1  0  2  1  1  1  1  3  1  0  3  3  3  1  0  0  3  2  0  2  3  3  0  0
0001131333003321101232122122333213100110
0113010222201030121212312121133203313032
3 1 1 2 0 3 3 3 2 0 1 0 3 2 2 0 0 3 3 1 3 2 2 2 2 2 3 0 2 3 0 2 3 0 3 2 0 2 3 0
1222000110032322321222310220022202010132
2020202031210003210313300232101012002210
2  3  2  1  1  1  1  2  0  3  1  0  3  0  1  3  3  0  0  0  1  0  0  1  0  2  0  1  2  3  1  1  3  1  0  1  0  1  0  2
2010300030122231332132303132202131013222
3  1  0  1  0  1  0  2  2  2  1  0  3  3  1  2  3  0  1  2  2  0  2  3  0  1  3  3  2  1  0  3  3  1  0  3  2  3  1  2
2  2  1  1  2  3  1  1  2  0  1  1  1  0  3  2  3  1  0  2  2  0  3  3  3  2  0  0  3  3  0  1  2  0  0  3  2  3  0  2
3 1 0 1 3 2 2 1 2 3 2 2 2 3 0 3 2 2 2 1 3 3 1 0 0 1 3 2 1 0 3 1 1 3 3 2 3 2 0 2
0  1  3  3  3  0  0  1  0  1  0  2  1  1  3  2  3  1  3  3  1  1  2  2  2  1  1  0  3  0  3  3  3  1  2  0  1  1  2  2
2 3 0 3 2 0 2 0 2 3 3 1 0 1 1 3 3 2 1 1 3 1 1 1 3 0 2 0 0 2 1 3 1 1 1 1 3 3 0 0
1 0 1 1 0 1 0 1 0 0 1 0 0 0 0 0 1 0 0 0 0 1 1 1 1 0 1 1 1 1 1 0 0 0 1 0 1 1 1 0
