0  1  0  1  1  3  3  0  0  2  3  1  3  0  3  1  1  2  3  2  0  1  1  1  1  3  0  1  1  0  3  2
0  2  2  1  1  2  3  2  0  1  1  0  0  2  2  3  0  3  2  2  1  2  0  2  0  2  2  1  1  3  3  0
02330300102231220102311000121300
2  2  2  2  2  0  1  3  2  0  2  0  3  2  2  1  2  2  0  1  0  2  3  2  3  1  1  2  1  2  0  2
2 0 0 3 1 3 1 2 2 1 2 3 3 3 3 3 2 1 0 1 0 2 2 1 2 3 0 3 2 3 0 2
0  2  1  0  1  3  3  1  0  0  2  2  1  0  2  0  1  2  0  3  0  3  3  1  3  3  3  3  0  0  3  2
33230132301032330312030133103132
0  2  0  0  0  0  2  0  3  1  3  2  0  2  3  2  3  3  0  0  3  1  3  1  2  1  2  0  2  3  1  0
3  0  2  0  3  1  0  1  0  1  2  2  0  0  1  2  0  3  2  1  0  3  3  0  3  3  0  3  2  0  3  2
1  0  3  3  3  3  2  2  3  0  0  2  0  3  2  0  0  3  3  2  1  3  1  3  2  2  3  2  1  1  0  2
1  3  2  1  1  3  1  1  3  3  0  3  2  3  1  3  1  2  0  0  3  2  0  3  1  0  2  1  0  2  1  2
1 0 3 2 0 2 1 2 0 2 1 0 2 3 0 1 2 2 0 3 0 3 1 1 1 3 3 1 0 2 3 2
0  3  2  0  0  3  1  0  0  2  1  3  2  1  3  0  2  0  1  1  3  0  1  0  2  0  3  2  1  3  3  2
1 0 3 1 3 1 2 0 3 3 2 1 1 2 3 2 0 2 0 3 1 2 1 0 0 2 0 1 1 0 3 2
2 0 3 3 1 1 3 2 1 3 2 1 1 2 1 2 3 1 0 1 3 0 2 2 0 3 0 2 0 2 0 0
0  1  1  0  3  2  1  1  1  3  0  1  3  3  1  1  3  1  0  3  1  1  0  3  1  0  3  2  2  1  1  0
02202013133021123023122310301232
1  1  2  0  0  0  1  3  2  0  0  2  3  2  0  2  2  0  3  3  1  0  0  0  0  1  0  2  3  0  3  0
3  0  0  2  3  1  0  0  3  3  0  2  1  3  1  0  1  0  3  2  1  2  2  3  0  2  1  1  1  3  2  0
1  1  0  3  2  1  3  0  0  3  0  0  0  0  3  2  3  1  1  2  0  1  2  3  0  0  3  2  0  0  0  0
3 3 1 1 2 2 3 0 1 2 0 1 2 0 2 3 1 0 2 2 3 2 2 2 3 2 3 3 3 3 3 2
13102230001112122230030202230202
2 2 0 3 1 1 1 0 2 1 2 3 1 1 3 1 1 3 0 3 2 0 2 2 0 3 0 0 3 3 3 0
2 1 1 3 1 3 1 3 0 2 2 0 0 3 0 1 3 2 1 1 3 0 3 2 3 3 3 3 2 1 0 0
1  1  0  3  1  1  0  0  0  0  1  0  0  3  0  1  1  2  3  2  0  2  0  1  1  0  0  2  1  2  1  2
0 1 3 2 3 2 3 2 1 3 1 2 3 2 1 3 2 2 2 3 1 2 3 0 0 0 3 0 2 1 1 0
01001233133030232021332333021202
1 0 0 1 0 1 2 3 3 0 0 0 3 1 0 0 2 2 2 3 3 0 2 3 0 1 2 0 2 0 1 2
1 1 1 1 0 0 0 0 1 0 1 1 1 0 1 1 0 0 0 0 1 1 1 1 1 1 1 0 1 1 0 0
