2 1 0 2 2 1 0 3 0
3 1 2 1 3 0 2 0 2
223101322
000012232
113101120
2  2  0  2  2  1  2  0  0
332030130
2  2  2  3  3  1  0  2  2
0 2 1 2 2 1 3 1 0
1 3 2 3 3 2 0 2 0
211130232
0 1 0 1 2 1 0 2 2
2  3  1  1  2  1  2  0  0
1  1  1  2  2  3  1  1  2
3 2 3 0 2 2 3 2 2
100110000
