3  2  0  2  1  2  3  2  3  0  0  2  0  1  3  3  0  1  3  0  0  1  0
1 2 2 3 3 1 0 1 3 1 3 1 0 2 3 3 0 3 1 1 0 2 2
03231122103130031112220
01000032111032131003012
2  0  2  1  3  1  1  3  2  3  1  1  2  2  2  3  1  1  3  2  3  2  0
1 3 1 0 0 1 3 2 3 1 3 1 0 3 2 3 2 2 2 2 0 3 2
0  1  3  3  2  2  2  3  1  0  3  3  2  1  2  0  0  3  2  1  0  3  2
0 2 0 1 2 1 2 1 1 2 3 3 2 2 0 1 3 1 0 0 0 3 2
21112001130012333230100
02130110103010013123012
2  0  0  2  1  2  0  0  0  2  0  3  1  1  1  2  1  0  2  0  0  3  0
13331300220111203133112
1  0  1  3  3  1  2  0  3  3  0  1  2  0  1  0  0  2  1  1  3  2  0
1 3 1 3 0 3 1 3 0 3 3 1 3 0 2 0 0 2 0 1 2 0 2
10212003010123101333210
20301003111232323332200
11021121322230300302010
33301020300001221112002
3  3  1  1  2  3  2  3  0  3  0  2  2  1  0  2  2  3  3  0  2  3  0
3 3 1 2 0 0 2 1 0 1 2 0 1 0 3 2 0 2 1 0 1 1 2
11101100100100111111000
