3 2 2 1 0 2 2 1 0 0 3 0 3 1 0 2
3 0 2 2 3 2 0 2 0 0 2 2 2 3 0 0
0332113033321230
1133031321112102
0  2  1  3  0  1  1  0  3  0  3  2  1  2  0  2
3  1  2  3  0  1  3  1  3  0  0  3  1  3  2  2
0  2  2  2  3  0  1  2  1  1  3  1  2  3  1  0
2013301210133132
0 0 1 3 3 0 2 3 1 2 2 3 1 3 3 0
1103111033322232
2  0  1  2  3  3  1  3  1  3  0  2  3  3  0  2
2313010312111310
0331312201103100
1  1  1  1  1  2  1  1  3  3  1  2  3  1  1  0
0112003030131020
0  2  2  2  0  2  3  0  1  2  1  3  2  1  3  0
0 3 2 3 1 0 2 0 3 3 2 2 2 0 0 2
3 0 1 3 0 3 2 3 2 1 2 0 2 3 0 0
2312331213003330
1100302101313120
2 0 0 1 0 2 0 0 0 2 0 1 0 1 3 0
0122030202030110
3 2 0 0 0 0 1 3 0 0 3 3 0 0 3 0
0220312112303222
0 2 3 1 3 1 0 2 2 0 3 1 1 0 0 2
1122230301123132
3 0 0 0 3 0 0 3 1 2 2 0 3 2 2 2
1  2  3  3  1  3  3  0  0  3  3  2  0  3  1  0
3320331210132032
3 0 3 0 0 0 0 3 1 0 3 0 2 0 3 0
0 0 0 1 1 0 0 1 1 0 0 0 1 1 0 0
