0221230333311112210013322221212301322
1121031130120333122303333330332123132
0 2 1 2 1 0 2 1 2 2 1 1 0 0 0 0 0 3 3 2 3 0 3 0 0 1 0 3 0 1 2 1 1 2 0 3 0
3  0  3  2  0  3  0  0  0  2  0  3  2  2  3  0  2  3  0  3  0  1  3  3  3  0  0  2  1  3  3  0  1  2  3  2  0
2  1  1  3  1  2  1  2  1  1  2  2  1  2  3  3  3  1  1  1  2  0  1  3  0  1  0  3  0  0  0  1  2  3  0  0  2
1  3  2  3  1  2  0  1  3  3  3  3  3  1  2  3  3  3  3  0  0  3  0  1  0  1  3  2  3  0  2  3  3  2  3  2  2
3  0  0  3  2  2  1  3  0  2  1  2  0  1  0  0  2  2  3  1  2  0  2  0  3  1  1  2  1  2  2  2  0  1  0  0  0
2033230130113232322012220312220200122
0 3 3 3 1 0 0 1 2 0 2 0 3 0 2 3 1 2 0 1 1 1 3 2 0 1 3 1 1 1 3 3 0 2 0 0 2
2 3 0 0 2 0 2 1 0 2 1 1 2 3 1 0 0 1 2 0 1 3 0 1 2 1 3 2 1 1 3 2 1 1 1 0 0
3311122002200211012311222231222130310
3 0 0 2 3 0 1 2 2 0 2 2 0 1 2 0 0 3 0 0 3 2 0 1 1 2 1 1 1 3 0 1 2 1 2 0 0
2 3 2 0 3 0 2 0 3 0 0 3 1 1 3 0 0 2 0 3 3 2 2 1 1 0 2 1 2 2 0 2 0 3 3 2 0
0333102032103212232033023213111112330
2303020231222031322222130032212013200
2302101200231202332112231133200110132
0 3 2 0 2 0 2 3 2 2 0 0 2 3 2 2 0 3 1 1 2 3 0 2 1 3 0 3 3 1 2 1 2 2 2 1 0
0231333211110120331230230123013221310
1 2 1 3 2 2 0 0 3 1 1 2 1 2 2 0 3 1 1 1 3 2 3 0 3 3 1 1 3 0 3 3 3 0 0 1 2
0  1  2  0  1  3  3  1  2  2  3  3  0  2  2  0  1  3  3  3  1  1  1  2  2  0  0  2  2  3  3  3  1  0  0  3  2
0 0 2 2 2 3 2 0 0 3 2 1 0 1 3 2 0 3 3 2 3 2 2 3 2 0 1 0 3 2 1 1 3 3 1 2 0
1100111101001100110110011010010010000
