00000131232111120031020312
3  3  0  0  0  2  1  1  3  0  1  2  3  1  1  1  3  1  2  1  3  2  2  1  3  0
0  0  2  1  0  0  2  3  3  0  3  0  2  0  3  3  3  1  1  1  1  1  3  2  1  2
10111122102000313032120022
1  3  2  1  0  2  0  2  1  3  3  0  0  1  1  1  0  0  1  3  0  0  3  0  1  0
01122031323010131332103132
0 3 1 3 1 1 2 2 2 1 1 0 0 0 0 1 0 2 2 2 0 3 0 0 0 0
0 1 1 0 1 0 0 3 2 0 3 0 0 0 0 0 3 0 2 1 3 2 0 1 1 2
1  0  1  3  3  0  1  0  2  3  3  2  2  0  0  2  2  2  0  2  0  2  3  1  2  0
20223103223130000310233300
1  3  0  2  0  1  3  2  0  2  2  3  0  3  2  1  0  2  0  1  0  0  3  1  2  0
0 2 1 1 0 1 0 3 2 3 3 2 3 0 3 2 3 2 2 3 3 2 1 1 1 0
2  1  3  0  3  0  1  0  3  2  2  3  1  1  0  1  1  1  0  2  2  2  0  3  3  0
31102120321133200232013112
1 3 1 2 0 3 3 3 2 2 1 1 3 3 1 2 0 3 3 3 0 2 1 1 1 0
0 3 2 1 0 2 3 3 0 3 3 0 2 2 0 0 3 3 3 0 2 0 3 2 0 0
03210010002212312033030030
10212213210033133211202300
0 0 2 2 1 0 0 3 0 2 0 2 1 0 1 3 2 2 2 3 0 3 3 3 1 2
01222113003131010211122010
3  0  0  0  2  0  3  3  1  2  0  2  3  0  3  2  1  3  3  1  2  1  0  1  2  0
21313301212010120213330022
0  3  2  0  0  2  0  3  0  1  0  3  0  0  1  3  2  1  3  3  3  1  3  0  3  2
21222132030212312020011322
1 0 1 1 1 0 1 0 1 1 1 0 0 1 1 0 0 0 0 1 1 1 1 0 0 0
