200101322
3 0 0 1 0 1 0 0 0
110302222
031231300
300202010
1 3 2 0 3 0 0 2 0
200203330
2 2 3 1 1 0 2 3 2
3  1  0  3  3  1  2  1  2
313311210
031122232
2  0  1  3  1  1  1  3  2
1 3 1 1 0 0 3 1 0
2 0 2 0 1 3 3 0 0
1 3 0 3 3 3 1 3 2
2  2  1  2  3  0  3  0  2
3 0 3 1 0 1 2 1 2
0  0  0  3  2  1  2  1  0
0 2 2 1 1 1 1 2 0
0  0  1  1  0  0  0  0  0
