2 1 3 2 2 2 2 1 2 3 3 1 0 3 2 3 2 1 0
3  0  3  1  0  0  1  1  2  3  0  2  3  2  3  1  1  0  0
0102023233103122102
3321201022130230120
3 0 1 3 3 1 3 3 2 0 3 2 3 2 1 2 2 3 0
1122132031022223000
0030132300030202300
0  0  2  2  1  0  0  3  0  2  1  0  3  3  3  2  1  0  2
0212220120210301222
3  3  3  3  3  0  0  3  3  0  3  1  1  3  0  3  3  0  2
1323112302330211112
1  3  0  0  2  0  0  1  1  3  2  2  1  3  3  3  0  2  0
2330330003120021012
0003112102300030220
0222123022331102302
0 2 3 2 3 0 1 1 3 0 1 1 0 2 3 2 1 0 0
0  0  3  0  1  0  0  0  0  0  3  2  1  1  0  3  0  3  0
2  3  2  1  1  1  0  0  1  2  1  0  1  2  2  3  3  3  2
1  2  2  3  0  0  0  1  1  1  0  1  2  3  3  0  3  0  2
3  0  1  0  3  1  1  1  1  0  0  3  2  0  2  0  3  1  0
0 1 3 3 1 3 3 3 2 3 2 3 3 2 2 2 3 0 0
1  0  1  1  1  0  1  1  0  1  0  0  1  1  0  0  0  1  0
