0 1 1 1 2 0 1 2 0 3 1 1 0 1 2 0 3 1 3 3 3 2 2 0 0 0 0 0 3 2
0 3 2 0 1 1 3 1 1 0 3 0 3 1 1 2 3 2 2 2 1 1 1 3 0 0 3 0 1 2
311013021222133221100021221310
202123100113322302203010322002
031112131111332230201123232330
0  1  3  2  3  2  3  2  1  2  2  2  1  1  1  0  3  1  2  3  1  0  3  3  2  0  3  1  1  0
2 0 2 0 1 0 2 0 1 0 1 0 1 0 3 3 3 0 1 0 1 2 0 0 1 2 3 3 0 2
0  3  2  2  0  3  2  2  1  3  0  2  2  0  3  1  1  0  1  1  1  3  1  3  0  2  0  2  3  0
0  0  2  0  1  0  2  2  0  0  0  0  0  2  1  1  2  3  2  3  1  0  2  2  0  1  1  2  2  0
010310000331310001032000123232
210130212310320001131332321312
2 0 1 0 3 3 1 1 1 2 2 3 1 2 1 2 3 2 0 0 0 1 3 0 2 0 2 1 2 2
1 2 0 3 0 3 0 3 1 3 1 1 3 2 3 1 1 1 3 3 3 1 0 0 0 1 2 0 2 0
0  2  2  3  3  3  1  3  2  1  3  3  1  3  2  3  0  3  3  1  0  2  3  2  1  0  3  0  1  2
0  2  0  0  3  3  1  2  2  1  3  0  0  3  2  3  1  3  3  0  0  1  1  1  2  2  3  3  1  2
0  3  1  3  3  3  2  3  1  1  2  2  2  1  3  1  2  3  3  3  3  2  2  3  1  2  0  1  2  0
021001002003220330130313313232
0 1 1 3 1 2 2 2 2 1 2 0 1 1 2 2 2 3 0 0 2 2 1 2 0 3 3 3 0 2
0 0 1 3 3 1 0 3 3 2 2 2 0 1 1 3 2 1 2 0 3 2 2 3 3 1 2 0 0 0
323100031010111331122313210220
1 3 3 1 2 2 3 3 0 3 0 3 3 3 3 2 1 3 2 3 0 0 0 1 3 2 2 3 1 0
0 1 2 0 0 3 0 3 1 0 3 0 3 0 0 1 0 1 2 3 2 1 0 3 2 0 1 0 0 0
3 1 2 3 1 2 2 3 2 3 2 2 1 2 3 0 3 1 0 0 2 2 3 0 3 0 0 3 2 0
2  1  0  3  0  3  3  1  0  1  1  1  2  2  0  0  0  3  2  2  1  1  0  2  2  0  2  3  2  0
031012121233003013110210022322
2 1 0 3 3 1 0 3 0 0 2 0 2 1 0 3 3 3 2 0 0 3 0 3 3 2 1 2 3 2
1 2 0 2 1 3 0 2 2 3 2 0 0 3 2 2 1 1 0 1 1 1 3 0 1 0 1 0 2 2
3 0 0 0 2 1 3 2 0 3 3 2 2 0 0 0 1 3 1 0 3 3 1 1 3 3 0 1 1 0
2 3 1 1 2 0 2 3 0 1 3 1 1 1 1 1 1 0 2 0 1 0 0 1 0 2 1 3 2 0
130002011331122301123321020100
101000000101111111010100111010
