0 2 3 0 1 3 0 1 0 1 2 0 0 3 2 3 1 2 1 3 2 2
0210022200311233020330
1 1 0 1 0 2 0 1 1 0 2 1 2 1 2 1 0 2 0 3 1 0
2  1  2  2  3  3  1  2  1  3  2  3  2  3  3  1  3  2  3  2  1  0
1 3 3 2 3 0 3 3 2 0 2 0 1 1 2 3 1 3 2 0 3 2
1221123030012021200230
3 0 3 3 3 0 1 2 1 2 1 0 3 0 1 0 1 3 3 1 0 0
3  0  1  2  2  3  0  1  1  2  2  0  2  0  3  2  0  3  0  1  0  2
2  3  3  2  1  2  0  2  1  2  2  0  1  2  3  0  1  2  1  2  0  0
3033300212332012212110
1  0  2  0  1  0  3  3  1  2  0  2  3  1  0  3  3  2  3  3  0  0
3 2 1 1 1 1 3 1 0 2 2 1 2 0 3 2 2 1 0 0 2 2
2  0  3  3  1  3  2  0  3  3  1  3  0  2  3  0  0  2  0  2  3  0
0012033330130123123022
3123223012020102321132
2  3  1  2  2  3  2  0  0  2  2  2  3  1  1  2  0  1  3  1  1  2
3020210320003302213030
0301212312311230100100
3  0  1  1  2  3  3  3  0  2  0  3  0  0  3  3  2  3  1  3  0  0
1  3  3  3  3  2  2  3  3  1  1  3  3  2  1  0  0  2  2  1  1  2
2  3  2  0  3  1  1  0  0  2  3  0  2  3  1  2  1  2  0  0  3  2
1 1 2 2 2 2 0 2 0 3 1 2 2 0 0 1 3 3 3 2 3 2
3113333233303321230212
2202312012311012021120
2 3 0 1 0 3 3 1 3 3 1 3 2 1 3 0 2 3 0 1 3 2
2  1  3  3  0  0  1  0  0  0  0  1  0  3  3  2  0  1  3  2  1  2
1011001010101101000100
