0  1  3  2  0  1  3  2  1  0  0  0  2  0  1  0  1  3  1  0  1  0  0  2  3  1  0  0  3  2  0  3  2  0
2  2  2  2  3  3  2  3  1  3  1  3  3  2  2  3  2  3  0  0  1  3  2  1  3  0  1  0  0  3  2  2  1  0
1223321021232032230010221210002000
3310113321131323313220033313200332
1211313322023010222000031002301032
1301003313201023300102221221313202
2 0 2 2 2 1 0 2 0 2 3 1 0 2 2 3 0 3 3 2 3 1 3 1 1 3 2 1 3 3 3 2 0 2
2  1  3  0  2  3  1  3  2  1  3  1  1  2  0  3  2  0  2  1  3  2  1  0  0  3  3  0  2  0  1  2  0  0
0 2 1 0 0 1 2 1 0 0 3 3 1 0 1 0 1 1 1 3 2 2 0 0 1 1 1 0 2 3 2 2 2 0
0102120220333013133233000130003010
1123011322201230101112011012300000
3 0 1 2 1 2 1 0 2 1 0 1 3 1 3 2 2 3 0 1 2 1 1 0 0 3 2 2 0 1 0 3 0 0
3000112320123111220031133021223210
1 2 3 0 1 1 2 3 3 1 3 2 2 2 3 3 1 0 1 3 1 2 2 1 2 2 2 2 1 2 1 1 3 2
0  0  3  1  1  0  3  2  3  2  3  2  0  1  1  3  1  0  3  1  1  1  1  0  1  3  3  1  3  2  2  2  0  2
3  0  1  0  1  3  0  2  2  2  0  1  0  0  1  2  1  2  2  0  2  3  0  1  2  0  1  0  3  1  3  0  0  0
0103223220301302103021233200021322
1  0  0  2  1  1  2  1  2  3  1  3  2  3  1  2  1  3  2  0  2  3  1  0  3  0  0  2  3  3  2  3  3  0
3 0 2 3 3 3 2 1 3 0 3 2 0 2 3 3 2 0 3 3 0 1 0 3 3 3 2 3 0 3 3 2 3 2
0 3 1 0 1 0 0 0 0 2 3 1 0 1 1 1 0 2 0 0 0 0 1 3 2 0 2 0 2 2 3 3 1 0
0  0  0  1  0  3  3  0  2  2  3  3  2  2  3  0  2  0  2  0  1  0  3  0  2  0  3  0  0  3  3  3  0  2
0 1 0 0 1 0 1 0 1 1 1 0 1 0 1 0 1 1 1 1 0 0 1 0 0 0 1 1 1 1 0 1 1 0
