112310221202233033332210300
0 0 1 2 0 0 1 3 3 0 0 2 2 2 3 1 3 0 1 3 1 3 2 3 3 2 0
221023023033312023102203332
0  1  2  1  3  0  0  0  1  2  2  3  3  3  3  0  1  2  3  3  2  0  3  2  3  3  0
2  1  0  1  2  3  2  3  3  0  0  3  1  1  2  1  2  0  1  0  3  3  2  0  3  3  2
2 2 2 2 3 3 0 2 2 0 3 1 3 2 2 1 1 0 3 2 3 3 3 1 0 3 2
0  1  0  3  1  0  2  2  1  3  1  1  3  3  1  0  2  2  2  1  2  3  3  3  0  1  2
012211132032101233210312032
2 1 3 1 1 3 0 0 0 0 1 0 0 1 2 2 0 2 3 2 2 3 1 0 2 2 2
1 0 3 1 0 0 1 1 2 3 1 0 2 2 1 2 2 0 3 2 3 2 3 2 2 3 0
0 0 3 1 3 0 3 2 0 3 2 3 0 3 0 2 1 1 2 2 0 0 0 3 3 1 0
1  3  1  2  1  2  1  0  1  3  2  0  1  2  0  2  2  0  1  1  2  3  1  0  2  1  0
2 2 3 1 1 1 1 1 3 0 1 1 1 3 0 1 3 3 0 1 0 0 3 0 3 2 0
1 1 0 2 0 3 2 1 0 3 3 0 3 1 3 3 1 0 2 0 1 3 3 2 2 1 0
3 2 3 1 1 2 3 1 2 3 0 2 2 0 0 0 2 1 3 1 1 3 3 0 0 0 0
113221112210322130123211030
2 3 0 1 0 3 0 3 1 0 3 2 1 1 2 3 2 0 1 3 0 2 1 2 2 3 2
0  2  2  3  3  1  1  3  0  3  0  2  0  0  1  2  0  3  3  1  1  2  2  3  0  0  0
0 1 3 3 3 1 2 3 1 3 1 1 0 0 0 2 3 1 2 3 2 1 3 0 2 2 0
010231223102233120133322102
0 3 2 1 1 2 1 2 0 0 3 2 1 3 0 0 2 2 3 2 2 0 3 1 0 0 0
311002032112330210011203002
3 1 2 0 2 1 2 1 2 3 3 2 1 0 0 3 2 2 2 1 3 1 2 2 1 0 2
3 3 1 1 2 2 0 3 3 1 2 3 2 3 3 1 0 1 0 0 1 0 3 2 3 2 0
222030320133002233321120132
3  0  0  1  3  3  0  2  1  3  3  1  1  2  0  1  3  0  1  1  1  2  3  1  2  1  0
300200101320303133011011120
1  2  0  3  0  0  3  1  0  1  0  3  0  3  0  1  0  1  3  1  2  3  0  0  1  3  2
1  3  3  3  0  2  2  0  0  2  0  0  0  3  1  2  1  0  1  1  2  0  0  2  0  1  0
1 0 0 3 3 1 2 3 1 0 3 3 1 2 1 2 0 3 3 2 3 2 1 0 3 2 0
000011000010101100110001100
