0 3 1 2 0 2 2 2 2 3 3 2 3 1 1 1 1 0 2 1 1 1 1 1 0 2
03300001222330313330233020
3 2 3 1 1 0 0 3 0 0 0 3 0 1 1 2 0 0 3 0 3 1 2 0 2 0
1 2 2 1 1 3 0 2 0 2 3 3 2 2 1 0 0 2 2 3 0 2 0 0 3 0
2  0  2  0  1  1  0  3  3  0  1  2  3  2  3  2  3  0  3  2  0  0  0  2  0  2
01123310113313201201232212
3 1 2 3 0 3 1 2 0 3 3 2 2 2 2 1 2 1 1 2 3 2 1 3 1 0
2 0 3 2 0 1 2 2 0 1 3 2 3 1 0 2 2 0 2 0 3 0 1 0 3 0
10311013002233310100231022
32013002100223112323220200
33300333233330231020313330
0  3  0  3  3  0  3  1  0  3  1  1  0  0  1  3  2  0  2  1  3  1  1  3  0  0
1  1  3  0  0  3  0  2  2  2  3  0  0  0  3  3  0  3  2  1  0  1  3  2  0  2
00331112202232020101320000
23231200232230033131223332
3  3  0  0  0  1  3  1  2  1  3  3  3  3  2  0  1  1  1  0  2  3  3  0  0  2
01021203120333230020201010
2  1  3  2  2  3  3  1  0  2  1  1  0  3  1  0  2  3  1  0  2  2  1  0  0  0
31333210223322023132112130
0 1 1 1 0 1 1 1 0 0 0 1 1 1 0 1 1 1 0 1 1 1 0 1 0 0
