002103102220
200322213212
020211022002
330332312220
131031331300
3  3  2  2  3  0  1  0  3  3  3  0
321313010100
1  3  1  3  1  3  2  2  3  0  2  2
2  1  3  2  2  1  3  3  2  0  0  0
3 1 0 3 2 2 3 3 3 1 2 2
1 2 2 0 2 0 0 3 1 2 1 0
3  1  2  2  2  0  0  3  2  3  1  2
1  0  3  3  3  1  1  1  3  1  2  2
001100010000
