03000311301213130111101220221011032
3 2 3 1 2 3 2 1 1 2 1 0 1 1 0 3 2 0 0 0 2 2 3 2 0 2 3 3 1 0 0 2 2 0 0
2 2 3 1 1 2 3 0 1 0 2 1 0 1 1 2 3 2 3 2 1 1 3 0 2 0 2 3 0 2 3 1 0 1 2
10131331233013031203330021022121200
2 2 2 2 2 2 2 3 1 3 3 1 3 3 1 0 1 1 2 1 3 0 0 0 2 2 3 1 2 3 3 3 2 2 0
1 0 3 0 1 3 0 2 3 1 3 3 3 0 0 3 1 0 3 3 2 1 3 2 2 1 2 2 0 2 1 2 3 3 2
12202002002212311301023023232332132
0 2 2 3 3 1 0 0 2 2 3 2 1 2 1 3 1 0 1 2 0 0 0 0 0 3 2 0 1 0 2 2 1 0 2
21101302312332200130110013000313310
3 3 2 0 1 0 0 0 2 1 2 3 1 2 1 1 0 3 1 0 1 0 1 0 3 2 1 0 0 1 1 1 1 0 0
1  2  3  1  3  1  3  2  3  2  0  2  1  3  1  2  2  3  1  0  2  3  3  3  0  3  2  0  2  3  3  2  0  1  0
2  1  1  0  2  2  3  3  3  0  0  1  1  2  1  0  1  0  2  2  2  1  0  3  2  1  1  2  3  0  2  1  2  0  0
0  3  2  3  1  2  1  2  1  0  2  2  3  0  1  3  2  1  1  3  3  1  1  0  3  3  0  1  3  2  1  2  1  3  0
0  1  1  1  1  0  1  1  1  0  1  1  0  1  0  1  0  1  0  0  1  0  1  0  1  1  1  0  1  0  1  0  1  1  0
