32333033123113122331100001220000
1  2  1  3  2  0  0  2  3  1  2  1  3  1  1  2  0  3  1  0  1  1  2  3  2  2  2  0  2  1  1  0
1  0  3  3  0  2  3  1  0  1  3  2  1  0  0  0  3  3  2  2  2  2  0  1  3  2  2  3  1  1  1  0
1 1 3 0 1 2 0 0 2 2 0 1 2 2 0 0 0 0 1 2 1 1 2 1 2 1 2 0 1 1 3 0
1  3  2  1  0  1  0  0  3  3  2  3  0  0  1  1  0  3  3  3  3  3  0  1  0  3  1  3  2  3  2  2
23321023310122130002302203033330
31311302121200302133132222232120
2  2  3  1  2  0  2  2  1  3  1  1  0  0  0  3  1  2  2  2  0  0  2  0  3  0  1  2  1  0  3  0
1  3  3  1  0  0  1  3  0  0  1  1  1  0  0  3  1  3  2  1  3  1  0  2  3  2  0  0  2  1  1  0
2  0  0  2  3  3  0  3  3  3  3  0  3  0  1  2  2  2  2  1  3  1  3  0  0  2  0  3  0  1  2  2
3 2 1 2 3 2 0 0 1 1 1 3 3 0 3 2 2 2 1 2 3 2 0 1 3 3 3 3 1 2 1 0
0 0 3 1 3 2 0 2 1 2 0 2 1 2 1 2 2 1 3 1 0 3 0 0 3 2 2 2 1 3 1 0
0 1 2 1 0 1 3 1 3 1 0 2 1 2 2 0 1 1 1 0 3 0 0 0 2 1 2 1 2 0 2 0
1 1 0 2 2 3 3 1 3 2 3 1 1 2 3 3 2 1 2 3 0 1 0 1 3 1 2 2 1 3 1 2
0 3 0 1 3 2 2 3 0 2 1 1 2 3 0 2 1 0 3 0 1 2 1 3 2 1 1 2 0 3 2 0
2  1  1  0  2  0  3  2  3  1  0  0  0  1  3  0  2  3  0  1  0  0  1  2  1  1  3  3  3  0  1  2
2  2  2  1  2  1  2  3  1  3  1  3  0  3  2  3  1  0  2  3  2  3  1  3  3  1  1  0  0  0  0  0
23232213121021022012100202121220
21213211332111332133110300311020
1 0 1 0 1 0 1 1 0 1 0 1 1 0 0 1 1 0 1 1 0 0 1 1 1 0 0 0 1 0 0 0
