3 0 3 2 1 1 3 1 2 1 1 3 3 0 2 2
3  2  1  3  3  1  2  2  2  2  0  2  2  1  3  0
1 0 2 1 1 0 0 2 2 3 0 2 1 2 3 2
0101020302203220
1  3  3  3  1  0  2  3  1  0  2  0  3  3  3  2
0  3  2  2  3  2  2  0  0  2  3  2  3  2  0  0
1322331001102232
1132330312211212
2 1 3 3 3 2 2 2 1 2 0 3 1 0 1 0
1  3  1  2  1  2  1  1  0  1  3  0  3  2  2  2
2  0  0  2  3  0  1  2  2  0  1  0  3  3  3  0
0 0 1 0 0 3 2 0 0 3 0 1 1 2 1 0
1232230231101022
2  1  3  3  2  3  3  1  3  3  1  0  3  2  2  0
1  0  0  2  2  2  1  3  3  2  2  2  0  2  1  2
1213300212212132
1 2 0 3 0 3 2 2 2 3 0 2 3 0 2 2
2 2 2 0 3 3 2 3 0 1 0 1 1 3 3 0
0 1 3 0 2 0 2 1 0 3 3 3 2 0 3 0
0  3  2  2  1  1  1  2  1  1  3  3  1  3  1  0
1  2  1  1  2  0  2  2  2  3  2  3  3  3  3  2
0100010111011010
