1  1  0  0  0  0  3  2  3  1  2  2  0  1  0  2  0  0  2  3  2  1  1  3  0  2  3  0  2  1  3  3  2  1  1  0
3  2  2  0  1  1  1  3  1  0  0  0  1  1  2  0  1  2  1  0  1  1  1  1  0  3  2  3  1  2  2  1  2  3  3  2
2 3 0 2 2 0 1 1 1 0 3 3 3 0 2 3 1 1 1 1 2 3 3 1 1 2 0 3 3 1 3 3 3 0 1 2
2 3 0 3 1 3 3 0 2 2 2 2 2 0 1 1 1 2 1 0 1 0 1 3 1 0 0 1 0 2 0 0 3 2 0 0
0 2 3 3 2 2 3 3 0 2 1 0 1 2 2 3 0 0 3 2 3 1 1 1 3 3 1 1 2 1 3 0 1 2 2 0
1 2 0 3 2 0 1 3 0 1 0 2 3 3 0 1 0 0 2 2 0 0 3 2 2 2 1 2 2 0 2 3 2 3 0 0
0 2 0 3 2 3 1 3 0 2 0 1 2 3 2 2 3 1 0 2 1 0 1 3 3 3 0 2 0 2 1 3 2 1 1 0
1 1 2 0 0 0 3 3 0 1 0 0 0 3 1 0 2 0 2 1 1 0 1 1 0 2 1 1 2 2 3 2 1 2 1 2
0 0 0 0 3 0 3 3 0 3 0 0 0 1 0 2 2 1 1 0 2 0 0 2 3 1 1 3 3 0 1 1 3 2 1 2
0 3 2 0 0 1 3 1 3 1 1 1 0 3 0 3 3 1 3 3 2 3 1 1 3 1 2 2 3 0 2 0 3 0 1 2
3 1 0 2 3 3 1 3 2 3 3 2 3 1 1 1 2 0 2 3 0 2 1 0 0 0 2 3 1 3 2 2 2 0 3 0
3 1 0 3 0 3 1 0 3 0 3 3 0 0 2 3 2 3 3 0 0 3 3 1 2 2 1 3 1 3 2 2 1 3 0 0
1 2 1 2 2 2 3 1 3 2 1 3 3 1 3 3 3 2 0 1 2 0 2 2 1 2 0 1 1 1 2 0 3 0 0 0
1  1  3  3  0  0  1  0  3  2  1  1  1  0  1  1  3  2  1  3  2  0  3  2  3  0  1  1  2  2  1  2  3  0  1  0
232221322002223302112211100210102322
3  1  2  2  1  0  0  1  3  3  3  0  2  1  2  1  1  1  2  2  1  2  2  0  1  2  2  1  2  3  0  2  0  0  3  0
0 1 2 2 0 1 1 3 0 0 1 2 1 0 0 3 1 3 1 3 1 3 0 2 3 1 2 0 2 2 3 3 2 0 0 2
3 2 3 2 0 2 0 3 0 2 3 2 2 0 2 3 2 1 3 1 1 2 0 1 1 0 0 2 2 1 2 2 1 0 3 0
3 3 3 1 2 3 1 1 1 1 3 1 3 2 3 3 1 0 1 1 1 2 1 0 2 1 1 3 3 2 1 3 3 2 0 2
0 1 2 3 2 2 0 0 0 0 2 3 3 0 1 1 0 3 2 1 1 1 1 3 2 1 3 1 3 0 1 3 0 0 1 2
3 3 0 2 0 2 0 0 1 3 2 1 0 0 0 2 1 0 0 0 0 0 2 3 0 1 1 1 1 2 3 2 0 3 0 0
120031120302301203122230120310330222
1 3 0 0 3 0 0 1 2 1 3 0 0 1 2 0 0 0 2 1 0 0 1 0 2 3 2 1 3 3 3 2 3 1 1 0
322030022030130200302013012230200010
0 2 1 2 0 2 1 2 2 1 0 1 2 0 2 3 1 2 3 0 3 2 0 2 0 1 3 0 1 0 0 3 1 0 3 0
0  2  2  0  2  1  2  1  1  0  3  3  2  2  1  1  2  3  2  2  3  1  3  3  0  2  3  2  2  3  3  0  2  1  0  2
223111000330113120302332330011123000
3 1 1 1 3 3 0 0 1 0 0 3 1 3 2 0 1 3 2 1 3 2 3 2 1 1 3 1 3 1 0 3 1 0 3 2
3 0 2 0 2 2 1 3 2 2 3 2 3 1 3 3 1 2 1 1 3 0 0 3 0 1 3 2 2 0 2 2 2 2 0 2
002221302231311203301003310322203212
1 1 1 1 0 1 1 0 1 1 0 0 0 1 0 1 0 0 0 1 1 1 1 1 1 0 0 0 1 0 1 0 0 1 1 0
