2210213102320103102311330030010331323010
2  0  2  0  1  0  1  1  2  2  2  3  3  0  1  0  3  0  2  2  1  1  2  2  1  3  3  1  2  0  0  3  1  2  0  2  0  3  0  2
0  1  3  1  0  0  0  3  1  0  0  0  3  0  0  1  3  3  0  0  3  1  3  3  3  2  1  0  2  2  1  1  1  0  1  2  1  2  0  0
0010110223130321220033032032123130123120
2  2  2  3  2  3  2  1  1  0  3  1  1  1  3  2  3  3  0  1  1  1  3  3  3  0  2  0  0  2  3  3  0  0  2  0  3  2  2  0
1 2 1 2 0 1 1 3 2 0 1 0 1 3 2 0 1 2 0 1 3 3 2 2 3 0 2 3 3 3 0 0 3 2 1 2 0 0 0 0
0  1  2  1  0  3  0  1  3  1  2  1  1  1  0  3  1  3  2  1  1  0  3  3  0  3  2  0  3  2  1  0  2  0  3  0  2  3  3  2
2  2  2  3  3  2  2  2  2  3  1  0  2  3  3  2  1  0  2  2  1  3  2  1  2  3  0  2  1  3  3  2  2  2  1  1  3  2  1  0
0 2 0 0 1 2 0 1 2 3 3 0 2 1 3 2 3 3 3 2 2 0 0 1 1 0 1 0 0 3 2 1 0 1 3 3 2 2 0 0
1 3 1 2 0 3 1 0 1 1 1 3 2 3 2 1 0 1 2 1 3 3 2 0 0 1 3 0 1 2 0 1 3 1 2 1 2 3 0 0
2 3 3 0 0 2 1 1 3 0 0 0 1 3 0 0 2 3 1 1 2 2 0 2 1 1 2 3 2 1 2 1 2 3 3 1 1 0 0 2
1 3 3 0 0 3 0 3 0 1 3 0 1 2 1 1 3 1 0 1 0 1 1 1 3 0 3 2 0 2 2 2 0 2 3 1 2 1 0 2
2111230321030232300130133012121010222220
3113311320020022222323011221031221010302
1333320332011002210311233213020023113200
1  0  0  1  2  0  3  2  2  0  1  3  3  3  2  2  1  2  3  1  1  0  0  3  3  3  1  1  2  1  2  1  3  1  0  2  0  0  3  2
0  0  3  1  2  0  1  2  0  2  3  0  2  1  0  2  2  1  2  2  2  0  3  3  1  2  2  1  0  0  3  0  1  3  0  0  1  0  1  2
3123120233210313003121003112001102223132
0000013020301211020031222302301121023002
1  3  0  1  0  1  1  1  0  3  0  2  1  2  2  0  3  0  1  3  2  1  3  1  2  0  2  3  0  1  1  3  1  3  3  0  1  1  1  0
3220213323320232100230131220223100023230
3 3 0 3 3 2 0 1 0 3 1 1 0 0 2 3 0 3 2 3 2 2 3 2 0 0 2 0 3 0 1 3 2 3 1 2 0 2 2 0
1031022320113220323132213121222000003330
2 0 2 3 1 0 3 0 0 1 2 2 0 1 0 3 1 1 2 0 3 0 1 1 3 2 0 1 1 1 1 0 0 3 0 1 0 0 0 0
0311220323230323212303310201121011003110
3 3 2 3 1 2 0 3 2 0 2 2 3 0 2 1 0 0 0 1 0 1 3 3 2 3 0 3 3 3 3 2 0 2 1 1 2 2 2 2
1 2 0 0 3 1 1 3 3 2 3 0 3 0 1 2 3 1 3 3 1 3 0 3 0 2 3 0 1 3 3 0 0 2 2 0 2 0 1 2
2  2  0  3  1  2  1  2  3  2  1  1  0  1  0  0  0  0  3  2  3  3  2  3  0  0  0  2  0  1  1  0  3  1  3  2  0  3  1  2
1 1 0 0 0 0 1 1 0 1 0 1 1 0 0 0 0 1 0 0 0 1 0 1 0 1 1 1 1 0 0 0 0 1 0 1 0 1 0 0
