2 3 1 3 3 1 2 1 1 2 1 0 2 3 3 3 0 3 2
3302003303233310100
2  0  3  2  0  0  2  2  0  2  2  3  3  2  2  3  3  1  0
1131003303011120010
0 0 0 3 1 2 1 3 0 1 3 3 2 3 1 0 2 1 2
3321302233011131030
0 3 1 0 1 2 2 0 2 0 0 2 1 1 1 0 1 0 2
0 3 3 0 0 2 3 3 2 0 1 0 1 1 0 3 0 0 0
2230312323211032100
1321123321312010030
2101312131303111220
1  0  1  3  1  3  0  3  2  0  3  1  1  0  3  1  3  1  0
0 1 3 1 3 1 0 1 1 0 0 1 2 1 2 1 0 1 2
1 2 0 1 3 3 2 0 2 3 2 2 2 2 0 0 2 0 2
3130322301122323112
0101011111101111000
