0 2 2 2 3 2 0 2 3 0 1 3 2 3 2 0 2 2 0 3 2 2 2 2 1 3 2 0 2 3 3 0 3 3 3 0 3 2 0 2 2
1 2 3 2 3 0 0 0 0 0 2 2 0 3 1 1 2 3 3 2 1 3 1 1 0 1 0 1 1 1 3 2 1 2 3 2 3 1 3 3 2
3  2  2  2  2  2  2  0  3  1  0  2  2  3  0  2  3  1  0  3  2  1  0  2  2  1  2  0  1  3  1  3  2  0  0  1  2  3  1  3  2
2  2  0  1  3  2  2  2  1  2  0  3  1  2  0  0  2  3  2  0  0  0  1  0  3  0  1  0  2  3  2  3  1  2  1  3  1  2  2  2  2
1 3 0 0 2 3 0 3 3 3 2 2 0 1 3 0 1 3 3 2 1 3 1 0 1 3 3 2 2 0 2 1 2 0 3 1 1 0 3 2 2
02303120211102022013003312030332213312132
32200321233100031012122333232203223112230
2  2  3  0  3  1  2  2  1  1  1  1  3  2  0  1  1  1  2  2  3  0  2  1  0  2  0  3  0  0  0  1  3  3  3  3  0  2  2  0  2
1 3 2 2 2 2 2 0 1 3 2 0 3 1 2 3 1 3 1 2 3 3 0 2 2 0 3 0 2 2 0 3 2 1 1 1 3 0 3 2 0
0  3  1  1  1  3  2  1  3  2  3  2  1  1  0  2  2  3  3  1  0  3  2  2  0  1  0  3  1  2  1  0  1  0  2  3  3  0  0  3  2
23113201011303303212000103320102223313100
3 3 3 1 0 1 0 0 0 2 3 0 1 1 3 0 1 1 0 0 3 0 1 0 0 1 1 1 2 0 0 0 2 1 3 0 3 2 0 2 0
0  0  0  1  3  3  0  3  2  1  1  1  0  1  2  1  2  2  1  1  3  1  1  1  2  1  2  3  2  1  1  3  2  2  3  2  3  1  3  2  0
2 1 1 1 1 3 3 0 3 2 0 0 2 3 3 1 2 3 0 1 2 3 2 1 3 0 1 3 0 2 2 3 3 1 0 2 1 1 1 2 0
02110002330201123302110332212103330233132
01323301313002032310102311130130023031110
20002330333103032010323220201233122131300
0 0 2 0 3 3 3 2 0 0 2 2 3 1 0 3 0 3 0 0 2 2 1 2 2 0 3 2 2 0 1 1 2 3 1 2 0 0 3 3 2
1 1 0 3 1 1 1 3 2 1 3 2 2 0 0 3 0 2 1 1 2 2 1 0 3 1 2 1 1 2 1 0 0 1 1 2 1 2 1 3 2
3  3  1  1  2  0  3  3  2  0  3  0  0  1  0  0  2  2  0  3  1  3  3  1  0  3  0  2  3  3  1  3  3  0  1  3  0  1  3  1  0
1  0  0  2  1  0  2  3  2  0  1  1  3  2  0  3  3  0  0  2  2  0  0  2  2  3  0  3  2  1  2  2  3  3  0  0  2  0  0  3  2
3 2 2 1 3 2 1 3 0 0 2 0 2 1 0 3 1 2 0 0 3 0 1 0 3 2 3 1 3 0 3 2 3 2 2 0 1 0 3 3 0
1  3  2  2  2  2  0  2  2  3  2  2  3  2  0  0  2  3  0  0  3  3  1  0  3  2  1  2  0  2  0  3  1  0  0  3  2  0  0  0  2
23330112233003002131030302131113130120102
11103332200301201113332330322013131001312
3  2  2  1  2  3  1  3  2  1  1  3  2  2  3  1  1  1  3  2  0  1  1  1  2  2  3  3  2  1  2  3  1  0  1  1  2  3  3  0  2
00100101101001101111100100011001011011100
