3  0  2  1  3  3  0  2  0  2  0  0  2  3  2  2
0  2  1  0  0  2  0  0  1  1  3  1  3  2  1  2
1 1 2 3 2 1 3 2 1 1 1 0 3 3 3 0
0 3 0 0 0 1 0 1 3 1 0 3 0 3 0 0
0 0 2 2 2 0 1 1 2 1 2 3 3 0 2 2
1001203012123112
2  0  1  1  3  1  2  2  1  0  3  1  0  1  2  0
1  0  0  2  2  3  0  1  0  3  2  2  0  2  1  2
0 3 2 3 1 2 3 0 0 2 1 3 3 1 3 2
0111233231201220
2013023131313232
2 0 3 1 3 1 2 3 0 3 1 2 3 1 3 2
2 0 0 0 1 0 0 3 0 1 3 1 3 0 2 2
2  3  1  2  1  1  2  2  3  0  0  2  1  1  0  2
3 1 2 0 2 2 0 1 1 3 2 1 0 3 3 0
2112013202110020
3102031130110022
2  2  2  2  1  3  2  3  2  0  1  1  0  3  3  0
3002200002211212
3  0  1  3  1  0  2  3  2  3  3  2  2  2  2  2
2  0  1  1  2  1  1  0  2  3  3  2  2  1  1  2
2200210330322110
2 3 3 2 0 0 3 1 3 0 2 0 2 0 1 2
0232313232200000
0  1  1  0  0  2  2  3  1  0  2  2  0  0  0  0
0233330331323120
1  0  1  1  1  1  0  1  0  1  1  0  0  0  0  0
