3  3  3  3  1  2  0  0  1  3  1  2  2  3  3  2  0  0  0  1  2  3  0
2  2  2  2  0  1  3  1  2  2  1  2  0  1  0  1  0  0  2  1  1  3  0
12101120123200211022332
3 0 1 1 3 2 3 0 3 0 0 1 3 1 1 0 2 1 2 0 2 0 2
20331201302231011013002
1  3  1  0  2  2  3  3  1  2  3  3  1  1  3  3  2  2  2  1  3  0  0
2  0  0  0  2  2  0  3  1  2  1  3  1  0  0  0  1  2  0  2  0  3  0
0 1 3 3 1 3 2 0 2 1 2 2 2 0 3 2 0 2 0 3 0 1 2
2 3 1 0 0 0 1 1 1 0 1 2 1 0 3 0 2 0 0 1 1 0 2
0 0 0 0 2 2 3 3 3 0 1 2 0 0 2 2 3 2 3 3 3 0 2
0 0 3 3 1 2 0 0 1 2 1 3 1 1 3 3 2 0 0 2 0 1 2
1  3  0  2  3  3  2  0  3  1  1  2  2  3  2  0  0  0  1  0  2  0  2
01012100220321230223322
0  3  1  1  1  3  2  0  3  2  0  3  0  0  0  1  3  1  0  0  0  0  0
11203322113322210130212
12032002110031010232102
33333300311121220331300
2  1  1  3  0  2  0  2  0  1  0  0  2  2  3  3  1  3  1  1  3  0  0
33010001120002210323230
00313232000332333210000
03003230003331002303202
2  3  3  1  1  1  1  0  0  0  1  0  0  0  3  2  0  0  3  1  3  1  0
1  3  0  2  2  2  3  3  0  3  2  2  3  1  1  2  3  0  1  2  0  2  2
22003231223303210310322
10221033010330123300012
3  2  1  1  2  2  1  0  0  3  2  3  3  3  1  0  3  0  1  0  0  1  0
10100220310133131023000
2 0 3 1 1 2 1 1 0 3 1 0 1 2 2 3 0 3 2 3 0 2 2
0 0 3 2 2 0 3 3 0 3 3 0 2 1 2 0 2 0 0 2 3 1 0
0 1 1 0 0 0 0 1 0 1 1 0 0 1 1 0 1 1 0 0 1 1 0
