23210331112031310032300102310313030131120
1 1 3 3 1 2 1 0 1 0 2 1 0 1 3 0 3 0 1 0 0 3 1 1 3 3 1 0 2 2 0 2 0 1 2 0 3 0 2 1 2
1  1  1  0  1  2  0  1  0  2  2  0  0  1  3  0  3  1  2  1  1  0  3  3  1  0  2  2  0  0  0  0  2  2  2  3  0  2  1  1  2
2  3  3  1  3  2  3  0  1  3  1  3  0  0  0  1  3  2  3  0  0  2  2  1  3  2  0  2  0  3  1  1  0  1  1  0  2  2  2  2  0
2  0  3  2  1  1  2  2  2  1  2  3  2  0  1  3  1  1  0  0  1  1  3  1  0  3  0  1  3  2  2  3  1  3  0  3  3  3  3  1  0
1  2  3  2  3  3  1  2  2  2  3  0  3  0  0  1  3  0  0  2  2  0  0  0  1  1  2  0  1  2  3  3  0  0  1  3  2  2  3  3  2
2  2  2  2  0  2  3  3  3  0  0  2  2  0  0  3  3  0  1  3  0  0  0  2  1  2  2  3  0  3  0  3  2  0  0  1  2  0  0  1  2
1  3  3  3  1  3  0  2  0  3  1  2  3  0  1  1  3  1  1  1  0  0  3  2  2  0  2  1  1  3  3  2  1  2  1  1  0  2  3  3  2
23133133303031002300013031231030011133010
3 2 1 3 2 1 1 2 3 2 0 0 3 1 3 1 0 0 0 2 1 3 3 2 2 0 0 3 3 3 1 0 0 1 3 2 2 0 0 3 0
2 2 3 0 2 2 3 3 0 0 0 3 1 0 0 3 3 3 1 2 1 2 0 0 1 2 0 3 3 3 1 3 2 0 0 3 2 2 3 3 2
00323222220231001331210133200120032122312
2 3 1 2 3 0 1 1 2 0 2 2 2 1 2 3 0 1 0 3 1 1 0 3 1 0 0 3 2 1 3 3 2 3 0 3 1 2 0 0 0
2 1 1 3 0 2 1 1 2 1 2 0 3 2 1 1 0 3 2 1 2 0 1 0 3 3 0 3 3 0 0 0 3 3 1 0 1 2 1 3 0
00101100010111011101100111110100111100010
