11212220
11102012
1  0  2  2  1  2  2  2
1 3 3 2 1 3 2 2
3 0 1 0 3 0 1 2
30132120
3  1  3  3  2  0  2  2
1 1 0 0 0 1 1 0
