0331013302
1 2 1 3 0 2 0 3 1 2
2322330010
0 1 3 3 2 2 1 0 0 0
0220322110
2  2  2  0  2  0  0  0  3  2
2001203100
1  0  0  3  0  0  3  3  0  0
2  3  2  0  1  2  0  3  0  2
0303303230
2010231110
1331121022
2 3 1 1 2 1 0 3 2 2
0 2 2 2 0 2 2 1 0 0
2  3  1  3  0  2  2  0  2  0
0 0 2 0 1 2 2 3 0 2
2  3  2  2  1  2  1  0  3  0
2 3 3 3 0 3 3 2 2 0
0 3 3 1 1 3 3 1 1 0
2  3  1  1  3  0  1  2  3  0
3231121122
2  3  3  0  1  0  3  1  1  0
0102032322
3 3 2 0 2 3 3 0 2 2
0  0  3  1  3  3  2  0  0  2
0  3  1  3  0  3  2  3  0  2
0 0 3 3 1 3 3 3 3 0
3 1 2 0 2 0 3 2 1 2
0 0 1 1 2 3 1 1 2 2
0103101020
0  1  1  0  1  1  0  0  1  0
