2  1  2  2  0  2  1  0  1  3  0  0  3  1  0  1  2  2  1  2  0  1  1  0  2
2 2 2 0 1 0 1 1 3 1 1 2 0 0 3 0 3 2 3 1 3 3 2 0 2
2 1 0 2 1 1 0 0 3 1 0 1 2 3 0 1 0 2 2 1 1 1 3 3 0
3  0  3  1  1  1  1  0  1  2  0  3  3  0  3  2  0  2  2  3  1  2  1  3  0
0  1  0  3  3  3  0  2  3  3  2  3  3  3  1  0  3  2  0  3  1  3  1  2  0
0  3  0  0  3  0  1  2  1  0  0  0  0  0  1  1  2  2  2  0  1  0  2  3  0
0003130023212003311120022
1  2  1  2  3  2  3  3  1  0  2  0  0  2  3  3  3  2  1  2  1  1  1  0  2
0301100310312203223100310
1 3 0 0 2 1 3 0 2 1 3 2 1 0 3 0 1 2 2 0 2 3 0 2 0
3 1 0 1 2 1 1 2 1 3 1 0 2 1 3 0 3 2 0 1 1 3 2 1 2
1  1  3  0  1  2  0  0  2  2  0  2  3  2  3  2  2  3  2  3  3  0  2  0  2
0  0  1  1  3  0  2  2  1  3  1  0  1  1  3  3  2  0  2  0  3  3  0  3  2
2  0  2  2  2  1  1  0  2  2  0  0  0  1  1  2  1  0  1  0  0  3  2  3  2
2 1 1 0 0 0 0 2 2 0 3 2 2 0 1 2 2 1 2 1 0 1 3 2 2
1 1 0 1 2 2 1 1 3 2 2 3 0 3 2 3 1 2 2 2 2 3 2 2 0
3 0 2 2 3 2 3 2 2 0 2 0 3 1 3 2 1 3 1 1 0 0 2 3 2
0011213031202230121022122
0333232011300331010230210
3  3  2  1  0  0  0  2  2  0  3  1  3  0  1  3  3  1  1  3  2  0  3  0  0
0110101110010010011110010
