3 2 2 1 1 1 2 3 3 0 3 0 1 3 2 2 1 0 3 3 1 0 2 0 3 0 1 2 0 3 2 2 2
0 0 0 3 3 0 2 3 0 0 2 0 3 1 0 3 3 3 1 1 0 3 0 0 1 0 2 3 3 2 3 3 2
113011113132032202330010010321332
0  1  3  0  1  1  1  1  1  1  3  2  0  3  2  3  2  0  2  3  2  3  1  2  3  0  1  0  1  1  3  3  0
3 3 3 0 0 0 1 0 2 3 1 0 0 1 3 3 3 1 2 1 2 1 2 3 0 2 1 2 2 1 2 1 0
0  3  0  0  3  1  3  3  0  0  0  1  1  1  0  3  1  2  0  0  3  1  2  0  3  1  0  3  3  1  3  3  2
0  3  1  0  2  1  3  3  1  0  1  3  2  3  1  0  2  2  0  3  1  0  2  0  0  1  2  2  1  3  1  1  0
1 3 2 3 2 2 3 3 3 2 0 2 1 0 2 3 0 0 1 3 1 2 2 1 1 2 3 1 0 2 1 2 0
1 1 3 0 1 0 3 2 3 3 2 2 2 0 3 0 2 0 3 0 1 1 0 0 0 3 2 2 0 2 3 2 0
3 1 2 2 0 3 0 3 1 2 1 1 3 3 3 0 3 3 1 0 2 1 3 0 2 3 0 0 0 3 1 0 2
1 1 0 1 2 2 0 0 1 2 2 1 2 2 2 0 2 3 1 3 0 3 0 3 1 0 1 0 0 3 2 3 0
033231112221110002113000023323002
0 0 3 1 3 1 0 1 1 0 3 2 3 1 3 2 0 3 2 2 3 3 1 1 3 2 0 1 1 0 1 3 2
1  1  0  0  2  3  0  2  0  0  2  2  3  0  0  2  2  1  0  0  0  2  3  3  2  1  0  0  3  2  1  1  0
3  2  2  2  0  0  0  2  0  2  3  3  3  1  2  3  3  1  2  3  3  2  0  3  0  0  2  2  1  3  1  3  2
311301311111202110120111221030222
0  0  1  0  1  1  1  1  3  2  1  2  3  1  1  1  0  3  0  2  2  3  3  1  3  2  1  1  2  3  0  1  0
010223300031002221223320302012202
0 2 0 0 3 2 2 0 2 0 3 0 2 3 3 2 2 3 1 0 2 1 3 2 3 0 1 3 3 0 2 3 2
3 0 1 0 0 0 1 1 1 1 0 3 3 2 0 1 2 3 2 0 1 0 2 1 1 2 1 3 0 0 2 2 0
100323321022232132131112310332200
0 2 3 2 2 3 0 3 2 0 0 3 2 1 1 2 2 2 2 0 0 1 2 3 3 1 1 2 3 1 0 1 0
211023123132220230101220031321020
1  0  1  3  3  3  2  0  2  3  1  0  2  0  0  0  3  3  1  0  2  3  3  0  1  1  0  0  3  0  2  3  2
130233133103010111130032332213312
0 1 0 0 1 0 1 0 0 1 1 1 0 1 1 1 1 0 0 0 1 1 1 1 1 1 1 0 0 1 0 1 0
