203120032130323231302
0 0 0 3 3 2 1 3 0 2 3 3 0 0 2 3 2 3 3 3 2
3  1  2  2  3  1  2  0  3  3  1  1  1  3  3  0  1  1  1  0  2
0  2  2  0  2  0  2  3  2  1  1  3  0  0  3  1  1  1  1  1  0
202111033012122123200
3 1 3 3 2 2 2 3 1 2 2 1 2 0 2 0 3 0 3 3 0
1 0 2 2 2 3 2 0 3 0 2 1 3 0 3 1 3 1 1 3 2
3  0  0  3  3  1  3  2  0  1  3  0  0  1  3  2  1  1  0  0  2
2  1  0  0  0  0  0  0  2  1  2  3  1  1  2  0  0  0  2  0  2
113021321232223101002
1  0  1  2  1  0  0  1  0  3  2  1  0  0  1  3  2  3  0  2  2
233120320000223201112
3 3 3 3 2 0 2 2 3 2 2 3 3 1 0 3 3 0 0 1 2
3  1  2  3  0  0  3  3  0  2  3  1  3  2  3  1  3  1  3  3  0
301233202133303032310
1  1  1  3  0  1  1  0  3  0  3  2  0  1  2  3  1  2  3  2  2
1 1 3 2 1 2 2 2 0 0 2 1 2 1 0 1 3 0 0 0 2
001231101022022112310
200232321111103233232
3 0 1 3 0 3 3 3 2 3 3 2 1 1 0 3 3 0 3 1 0
0 1 0 1 1 1 0 3 0 2 0 3 3 0 3 2 1 3 0 1 0
0 3 3 0 2 1 1 2 3 1 3 3 3 1 2 0 1 3 0 3 0
110011101001101010100
