1031212030300132022
3 1 3 2 3 3 0 0 3 0 2 2 2 0 2 1 2 0 0
0 0 1 3 0 3 0 0 1 1 1 3 2 0 2 2 3 2 2
0 0 3 2 1 1 2 0 1 3 3 2 1 2 3 2 0 0 0
2  2  3  1  2  1  1  2  0  0  0  3  2  3  1  3  2  2  2
2203321333322010202
1 0 1 1 1 0 3 1 1 1 3 0 0 0 0 3 3 3 0
3131222321012132032
3  3  0  0  2  0  3  1  2  0  3  3  0  2  0  1  3  2  0
2 3 3 3 1 2 3 1 0 1 1 3 0 0 0 2 3 1 0
1  1  2  3  1  0  3  2  1  0  0  0  2  3  2  2  2  2  2
3231003013103203022
1 3 0 2 3 1 0 3 3 3 2 0 0 2 0 1 2 2 2
1211000311222222032
0 1 2 2 0 0 0 2 1 3 0 3 1 1 0 1 2 0 0
0 2 0 1 0 0 0 1 0 3 3 1 0 0 0 1 3 1 2
1021231020111130310
1  3  1  0  2  2  0  2  3  2  3  1  1  3  0  2  2  1  2
1 3 0 1 2 1 0 3 2 0 2 3 3 3 2 0 3 3 2
0 0 0 2 3 1 1 1 2 1 0 0 2 2 2 0 2 1 2
1001320012022323302
1  3  2  1  3  3  3  3  3  2  0  2  3  3  2  1  2  3  2
3 3 2 1 1 1 0 3 3 3 1 1 3 2 1 2 0 0 2
3 1 0 0 0 3 2 3 1 0 3 0 1 3 3 1 2 0 2
1  0  3  1  0  2  3  0  0  1  0  1  0  2  1  1  2  3  0
2310100321101020110
1  1  0  1  0  1  1  0  0  1  1  1  1  0  0  1  0  1  0
