2 2 0 1 3 2 1 2 3 0 3 3 2 1 1 3 3 3 1 2 0 0 0 1 0 0
03321001330133000112130132
00333201200000212023302132
1 0 2 2 2 0 0 3 1 2 1 1 1 3 3 2 3 1 2 1 0 0 2 0 0 2
32030310303120301121320210
0  2  0  2  2  1  1  0  2  1  2  0  2  3  1  1  1  2  3  1  0  3  0  1  2  2
3 1 0 0 2 2 0 0 1 1 1 2 3 2 2 3 2 3 3 0 3 1 1 2 1 0
1  1  3  1  2  0  3  0  1  3  1  3  1  2  2  1  2  1  3  0  1  1  0  1  2  2
1 1 0 1 1 0 2 2 3 1 2 3 3 2 2 1 3 3 2 0 2 2 3 3 1 2
2  2  2  3  3  0  3  2  2  3  3  1  1  1  0  3  1  0  3  1  1  1  3  0  3  2
1 2 1 1 1 0 1 2 1 2 2 2 3 1 3 2 0 2 2 2 2 3 0 0 2 2
22212003221111103003003012
12102113201221122010203330
1 3 3 2 1 0 0 0 1 2 0 3 3 2 3 1 2 3 3 0 0 1 3 2 0 2
2  2  3  0  1  1  2  0  2  3  1  1  3  2  1  2  2  2  0  3  2  3  0  0  2  0
1  2  1  3  3  0  0  2  1  0  1  3  1  3  3  3  0  1  2  0  2  3  1  2  1  2
2 0 3 1 1 1 1 1 0 2 0 1 3 3 0 1 2 2 2 3 0 2 0 0 3 0
3 0 1 1 3 0 1 0 2 0 3 0 2 2 1 3 3 3 1 0 0 0 0 1 1 0
1  3  0  1  2  0  0  2  1  1  2  0  0  2  3  0  0  0  2  0  0  0  0  2  3  2
23302101102123122300313330
31203113001033230012100310
10223211131310313330300202
2  0  0  1  3  1  1  1  1  3  0  2  2  0  0  3  3  2  2  1  0  1  0  2  3  0
1 1 1 1 0 1 1 0 1 0 0 0 1 0 0 0 1 0 1 1 1 1 1 1 0 0
