2  1  1  1  0  2  3  3  1  2  0  0  2  2  0  0  2  1  0  1  3  3  2  2  2  2
12010222213002332020301022
31302211212022200032232332
3  2  3  1  1  2  3  3  1  0  3  1  3  3  3  0  3  1  0  2  3  1  2  3  2  2
00301200333311302312001002
3  3  1  1  3  1  1  1  1  0  3  0  2  1  1  2  3  3  0  3  1  3  2  0  2  2
00121202111213101002021222
2  1  1  2  2  1  3  2  0  3  1  0  1  3  0  0  2  2  2  1  1  0  2  0  1  0
0 2 1 0 2 3 1 0 2 0 2 0 1 3 1 2 3 2 1 2 0 3 2 3 3 2
02103301030220002021030102
0 3 3 0 3 0 1 0 0 2 2 3 3 3 3 3 0 0 0 2 2 1 3 3 0 0
2  0  2  3  0  3  3  1  0  3  3  1  3  2  1  1  0  0  2  3  0  3  0  1  0  2
3  1  1  0  0  2  0  2  1  0  3  3  2  3  3  2  0  0  3  1  2  1  2  2  0  0
1  0  0  3  1  1  3  3  2  1  3  1  2  3  1  3  1  0  3  0  0  1  0  1  2  0
3 2 1 2 1 0 3 1 3 3 2 0 3 0 0 2 2 3 1 0 1 3 3 0 0 0
0 3 2 0 1 3 0 3 1 3 2 1 3 3 0 3 0 1 2 2 2 0 1 0 0 0
1 1 0 2 3 1 2 0 2 1 1 3 0 0 0 2 3 2 1 2 0 2 0 0 1 0
2  3  3  1  2  2  1  3  1  2  3  0  0  3  2  0  0  1  1  3  2  3  2  0  0  0
2  0  0  1  0  2  1  1  3  2  0  0  1  3  2  1  3  1  2  3  3  0  1  2  0  2
2 1 2 1 3 3 0 2 2 0 1 2 3 3 1 0 3 3 3 1 3 3 3 1 2 2
3 0 0 1 2 2 2 1 0 3 3 1 1 3 2 1 3 0 3 3 1 3 2 3 2 2
1  2  3  2  3  2  2  3  1  3  1  2  1  0  3  1  0  0  0  2  3  0  0  3  3  0
21022013332013010222111322
2  2  3  2  1  1  3  2  2  3  0  3  0  3  1  3  2  0  2  3  2  0  3  2  2  0
2  2  3  1  2  0  2  0  2  1  1  1  1  2  1  2  1  2  3  0  3  0  1  0  3  2
2 0 1 0 3 3 3 1 1 0 1 3 3 2 0 1 2 3 1 0 1 1 0 0 3 0
0  3  3  2  3  0  2  0  0  2  1  3  1  2  0  3  2  3  0  0  3  0  3  2  2  0
10133323203213131110200022
02333212310111012033032312
0 1 1 0 1 0 0 0 0 0 1 0 1 1 1 1 0 1 1 0 0 1 1 1 0 0
