120201310211311200232320102330100203030
303203302012002033022310113210012320232
231001300301200321331101132100113311302
2  0  0  0  3  0  1  3  2  2  0  2  2  1  3  3  3  0  1  3  3  2  1  2  2  1  1  0  2  0  3  0  2  3  2  1  2  1  0
0  0  0  2  0  3  0  1  2  1  1  0  1  3  2  1  0  1  0  2  1  3  0  1  3  1  3  2  3  2  0  3  0  0  1  3  3  1  0
0  2  3  2  3  3  2  0  2  3  0  2  1  1  3  1  0  0  3  2  2  0  0  2  3  0  2  2  0  2  3  2  0  2  3  2  3  0  2
032332022312121313201233021333130010112
1  1  1  1  0  0  1  2  2  2  3  1  3  0  1  2  1  0  3  1  1  3  0  0  0  3  3  3  0  3  0  1  0  3  3  0  0  0  2
121010103030131110320331000210021110132
103010001123022321121113112223113020302
212222013313211112321220132300333132100
1  1  1  0  3  1  0  3  2  2  0  2  1  2  3  2  1  0  0  2  0  3  2  2  2  0  2  3  1  0  0  1  1  2  2  0  1  0  0
3 2 3 3 0 1 3 1 2 3 3 1 0 3 1 0 3 0 0 3 2 0 0 1 2 3 2 1 2 3 0 3 3 0 1 0 2 3 0
3  3  3  3  3  1  3  0  0  3  1  0  1  0  0  0  3  1  3  1  1  3  1  0  2  1  0  0  2  3  3  0  2  3  3  0  3  0  0
0  3  2  1  0  2  1  3  2  3  2  1  3  2  0  3  3  3  2  1  3  0  1  2  0  1  3  2  1  0  1  1  0  3  3  2  1  0  0
1 1 2 2 3 3 0 2 0 0 3 1 2 0 2 2 3 1 1 2 3 2 3 0 0 1 2 2 1 3 0 1 1 1 0 1 2 3 0
202230112202103311233003023023302121130
3 1 0 1 2 2 0 3 3 1 0 2 3 0 3 0 0 1 0 1 1 1 3 1 2 0 3 3 3 2 3 2 0 3 2 2 0 1 2
1  0  0  1  0  0  1  1  0  0  0  0  0  0  1  0  0  1  1  0  1  0  0  0  1  0  0  1  0  0  1  1  1  0  0  0  1  1  0
