3  3  0  1  2  1  3  3  1  3  3  1  0  1  2  0  0  1  0  2  2  2  0
11201123233132110022310
0 3 2 1 3 2 0 2 2 1 2 2 1 1 0 3 3 3 0 2 1 1 0
2 1 2 2 1 2 3 2 0 3 0 1 1 1 0 1 0 3 1 0 2 3 0
30122203211101201320120
0 3 0 1 2 3 1 0 2 3 3 1 1 1 2 1 3 0 1 3 0 0 2
0  1  1  1  3  3  1  1  0  3  0  3  0  0  2  1  0  2  3  1  0  2  2
0 2 0 3 0 2 0 0 1 0 0 3 0 1 2 3 3 0 1 3 0 1 2
3  2  1  0  3  1  2  1  3  3  1  1  3  1  0  3  2  3  3  2  2  3  2
30002121100303033013132
02022222103320030132300
2  3  3  2  1  2  0  1  1  3  1  0  0  0  0  2  0  2  2  2  0  1  0
13210130110331300212230
1 0 0 1 2 0 1 0 1 3 3 0 2 0 3 3 0 1 3 0 0 2 0
1 0 0 3 0 3 2 2 1 3 0 2 1 1 1 2 3 1 3 3 2 2 0
1 2 2 0 3 3 1 1 0 2 2 2 2 2 2 3 1 0 0 1 0 1 2
21302002011201123221010
0  1  1  0  0  0  1  0  1  0  0  1  1  1  1  0  1  0  0  1  1  0  0
