1230323113121022110302311102320
3  2  3  3  3  1  3  2  1  0  3  3  0  3  0  3  0  0  0  3  1  2  3  1  1  3  0  0  3  3  2
3210030322022310022033201312332
1010330320021222322032012010100
2  3  0  1  2  3  1  2  1  3  0  3  3  2  2  0  2  0  0  1  0  3  1  0  2  2  2  3  3  1  2
1 1 0 2 0 1 3 1 3 1 2 1 3 2 2 2 1 0 0 3 0 2 2 0 0 1 2 0 1 0 2
1 1 1 0 1 1 2 1 1 1 0 1 0 3 3 0 1 1 0 2 1 2 1 3 2 3 0 3 1 2 0
0 2 2 1 3 2 3 1 1 1 1 2 2 2 3 0 1 3 3 0 0 2 1 1 2 1 2 3 3 3 2
2303113232103322232003120022230
0  1  2  1  0  3  1  0  2  3  3  1  1  3  0  3  1  2  2  1  1  3  2  2  1  2  1  2  2  1  0
2211000313231002001221010003232
1111332203032222212330301200300
3  3  3  0  1  3  0  3  0  3  1  1  0  1  2  1  3  3  3  3  0  2  3  0  1  3  1  3  1  1  2
0023012111331020312123310232002
2  3  3  3  2  0  3  1  1  0  0  3  1  3  1  1  1  2  0  0  1  2  0  2  1  0  2  0  3  0  2
0130300212220301302131230010330
2  0  1  3  0  3  3  3  1  3  3  1  1  1  2  1  3  2  2  2  1  1  0  3  0  1  0  3  2  1  0
0123322032300110211213023331320
1  2  1  3  1  0  1  3  0  2  1  3  1  0  1  1  2  0  0  0  2  2  2  0  1  2  0  0  3  3  0
0331112110213121321213312221012
1  3  0  0  1  3  3  1  1  3  2  3  0  3  0  0  1  0  3  0  0  3  0  2  0  2  3  3  3  3  0
0 3 0 3 3 1 1 3 0 2 3 0 3 0 3 1 1 0 0 0 3 3 0 3 3 0 0 3 2 1 2
2  1  3  2  2  3  2  1  1  0  3  0  3  3  2  0  2  0  3  0  3  3  3  0  0  1  3  2  0  2  2
3322033312132030313331300223032
1 0 0 0 0 1 1 0 0 1 0 1 0 0 0 0 1 1 1 1 1 1 1 1 0 0 0 1 1 1 0
