2 0 0 0 1 0 3 3 0 1 3 1 1 3 3 2 2 3 1 2 0 0 3 0 2
3330212103210310103032030
3003001312221200122230230
0 0 2 2 3 3 3 0 1 2 0 1 2 1 0 0 3 2 3 3 0 3 2 2 2
2100130301203323300330130
2 0 3 3 1 3 1 3 2 0 0 2 2 1 1 3 0 0 3 0 1 2 2 0 2
2  3  1  3  3  3  1  1  3  3  3  2  0  0  2  2  0  0  3  1  2  0  0  2  2
3 0 2 0 2 0 2 3 1 2 3 1 3 1 3 3 1 1 1 1 0 2 1 3 0
3  1  2  2  1  3  0  2  0  0  0  3  1  1  3  3  3  1  0  1  3  0  1  1  2
3023002012013333302333132
0 2 0 2 3 0 0 3 3 3 2 1 1 1 0 1 3 3 1 0 3 3 1 2 2
2 1 0 0 0 1 3 1 3 3 3 0 3 1 1 2 3 3 0 1 2 2 2 2 0
3  1  0  0  1  3  1  0  1  3  0  0  0  1  3  3  1  3  3  0  2  1  0  0  0
0  3  1  2  3  0  1  3  2  3  3  1  2  2  2  0  3  2  3  2  0  1  3  1  0
3 0 3 2 1 3 0 2 2 2 0 3 3 1 0 2 0 1 0 3 2 0 0 2 0
1  3  0  2  1  2  3  2  1  1  2  0  2  3  0  2  2  0  0  1  2  1  0  3  2
2  1  2  3  1  2  1  2  0  0  3  0  2  3  0  3  2  3  0  1  0  2  0  2  0
2 2 2 0 3 2 1 0 1 2 2 1 2 1 1 0 0 2 2 3 0 2 0 3 2
0010332003010100122222122
3 0 0 2 3 2 1 1 2 3 2 2 3 0 0 0 2 0 1 2 1 2 0 3 0
3 1 0 1 0 1 0 0 1 3 1 1 2 0 2 2 1 2 3 2 0 0 3 0 0
2 3 3 0 1 3 3 0 2 2 1 1 3 0 0 1 1 1 3 3 2 1 2 3 2
1 1 1 0 0 1 0 1 1 1 0 1 1 0 1 0 0 0 0 0 0 0 0 1 0
