33311031223113001321103333133132
2  2  2  2  1  0  1  2  3  1  0  0  3  2  3  2  0  0  0  1  1  2  1  1  2  0  0  0  0  0  1  2
2  0  3  2  1  3  2  3  0  0  2  1  3  3  0  1  1  3  0  0  1  3  2  0  0  2  0  1  1  2  0  2
3 3 2 2 3 1 3 0 1 0 2 2 1 0 0 3 0 0 2 2 1 0 2 0 0 0 3 1 1 1 0 0
1  2  2  0  0  0  1  1  0  1  1  0  3  1  0  3  1  2  1  1  2  3  0  1  0  3  3  2  3  1  1  0
3 0 1 0 3 1 0 1 1 2 1 2 3 2 3 2 0 0 0 0 2 3 3 3 0 0 0 2 2 0 0 0
3 3 1 3 2 2 0 1 2 2 3 0 2 3 1 2 0 0 0 1 2 0 1 3 2 2 3 2 0 1 1 0
0 3 1 3 1 2 2 1 1 3 2 3 2 0 1 1 1 1 3 0 0 1 2 2 0 0 2 3 1 0 3 2
0  2  3  1  0  1  3  3  1  0  0  0  1  1  3  0  0  3  1  2  0  3  2  1  0  2  1  1  3  0  1  2
2  3  1  1  0  0  3  2  0  2  3  0  0  2  0  2  2  3  2  0  1  0  3  1  1  1  1  1  3  3  2  0
30031322122210010220300210023330
1  3  0  0  1  3  3  0  2  1  0  0  3  2  2  3  2  2  1  3  2  2  3  0  0  1  3  0  0  3  1  2
32110103030321220321010201101130
2 2 0 0 1 1 3 0 2 3 1 1 1 0 3 2 2 3 3 3 3 0 0 1 2 1 3 1 1 0 0 2
0 3 1 3 3 2 1 2 3 3 1 0 2 0 3 1 2 2 3 0 0 3 2 1 2 3 1 1 0 1 2 0
20222122022002230032301121101212
00333330001031310000003120120202
3  0  2  1  1  3  0  1  0  2  2  2  3  1  2  2  0  1  2  1  3  0  3  1  3  3  2  2  0  2  2  0
0 1 2 0 0 3 3 3 1 0 2 1 0 2 1 1 3 3 1 1 2 3 0 1 3 2 3 0 3 0 1 2
3 2 3 0 0 1 2 2 0 3 2 3 1 1 1 3 1 0 3 1 0 2 0 2 1 1 3 3 1 3 0 2
21301300200313220002322223223030
1 1 3 1 1 1 3 1 2 2 2 3 1 2 2 3 0 3 2 1 2 1 3 3 1 1 3 3 2 2 2 0
31003012000031220010333201031200
3 2 1 1 0 0 3 1 3 3 3 3 3 0 2 0 3 3 2 0 3 0 0 2 1 0 1 0 1 0 3 2
3  0  0  3  3  0  1  2  2  3  2  2  1  2  3  2  1  2  2  1  3  3  0  1  3  2  1  3  0  0  1  2
0 0 2 0 3 0 1 3 3 3 0 3 1 3 1 2 3 2 1 2 0 3 0 3 1 0 2 3 2 3 1 2
3  1  2  0  3  3  1  2  1  3  0  1  2  3  1  3  0  3  2  2  2  3  2  3  3  2  1  2  1  3  0  2
1 0 0 1 1 0 1 0 0 1 1 1 1 0 0 1 0 0 1 1 0 0 1 1 0 0 1 0 1 0 1 0
