1  3  3  0  3  3  3  0  0  1  0  3  2  3  2  2  3  1  1  0  1  0  2  2  0  1  1  2  1  0  1  3  1  3  1  0  0
0  1  0  2  1  2  2  3  3  0  3  0  1  3  1  2  0  1  1  1  3  3  1  0  2  2  0  2  1  1  0  2  1  1  0  0  2
3  2  2  3  2  1  3  2  3  3  0  3  3  2  0  0  0  3  0  2  2  3  2  0  1  3  0  3  1  2  2  1  3  0  0  2  0
2313132320122230120311011110322033222
0 2 2 0 1 2 1 1 0 3 2 2 0 1 2 0 0 2 1 3 3 3 2 1 1 2 2 1 3 2 2 1 2 3 1 1 0
3 2 3 0 1 2 1 0 0 2 1 1 1 3 0 0 1 1 0 2 1 0 1 1 3 3 1 0 1 1 2 3 0 2 1 0 2
2  2  3  3  3  0  3  1  0  2  1  2  0  1  2  0  2  1  0  2  2  0  3  1  2  0  0  3  1  2  3  3  1  0  2  2  0
0 0 3 2 2 2 0 3 1 0 2 2 3 0 2 0 0 3 0 2 1 1 2 0 1 3 0 3 1 3 0 0 0 1 2 1 2
0 2 3 2 2 0 3 3 3 2 3 3 2 0 3 3 1 1 0 3 0 1 2 0 1 1 2 0 1 0 1 1 2 1 1 1 0
2  3  3  1  1  3  0  3  3  2  1  0  3  3  3  2  2  3  2  2  2  1  2  2  2  1  0  0  1  1  2  1  2  2  3  3  2
2010201230102333010100133022130032000
0  0  0  2  0  0  3  1  1  1  2  3  3  1  2  1  1  0  1  0  1  1  2  1  0  1  3  0  2  0  3  0  2  0  1  0  0
3 0 2 3 0 2 3 0 1 3 1 2 1 2 0 3 2 1 0 0 0 0 3 2 0 3 1 1 3 1 3 2 3 2 3 3 2
1 1 0 0 0 3 3 1 1 3 0 0 2 2 2 0 3 2 2 1 2 2 3 1 3 0 1 0 2 3 0 2 2 3 0 1 0
2  3  2  1  3  3  3  2  2  0  3  3  1  1  3  3  3  2  1  3  1  0  0  0  1  0  3  3  3  3  2  0  0  3  3  3  2
0 0 0 3 3 1 0 1 2 0 1 1 0 0 0 1 3 0 2 3 0 2 0 3 3 1 1 1 1 2 1 3 3 0 3 1 2
0022132230103330311112110201323020100
1120000313131020123103303121022213302
1103133310121322313232232230102233212
2 1 2 1 2 0 3 3 2 3 1 3 3 3 1 2 2 2 1 0 1 0 1 0 3 3 3 3 0 3 0 2 2 3 0 1 0
0 0 0 1 2 2 0 0 3 3 0 3 3 3 3 2 1 2 0 1 2 2 1 3 2 1 1 2 0 3 1 3 3 3 3 1 2
0 0 1 1 2 0 0 3 2 3 1 3 0 3 1 2 1 1 0 0 0 0 2 1 0 1 1 2 0 3 3 2 1 1 2 0 0
1  2  0  1  1  0  2  1  1  0  1  0  3  0  1  2  0  3  2  3  1  0  1  2  2  3  2  3  2  2  0  1  3  1  1  3  0
2 2 2 0 1 3 3 0 3 3 0 0 2 2 3 2 0 2 3 0 1 3 1 1 3 0 0 1 3 0 0 2 2 1 1 1 2
1110110111010111010110100101110100100
