3223113020
0  2  2  1  2  0  2  0  2  2
3033110220
0 1 2 0 2 3 3 0 3 2
2 2 2 3 1 1 2 3 3 2
2 1 3 0 3 2 3 3 1 2
1200000232
3  0  0  3  1  0  2  1  2  0
0 3 1 0 3 1 0 3 0 0
0221210200
2 0 2 2 1 1 2 3 3 2
0 3 2 1 2 2 2 2 1 0
1310301330
1322100320
0  0  3  1  1  3  0  0  0  0
3 1 3 2 3 1 3 3 2 2
0 0 2 3 2 2 0 2 3 0
1  2  2  3  2  0  2  2  3  0
2 3 2 1 1 1 1 1 2 0
2  2  0  0  1  1  3  0  0  0
1  0  2  1  3  1  0  0  1  0
0  3  2  1  2  1  0  0  2  0
2 3 0 2 3 0 0 2 1 0
0 2 3 1 0 3 0 3 2 2
1012211312
1003333312
1031020222
1 1 2 3 3 0 2 1 0 0
0  0  1  0  1  1  1  1  1  0
