2221010221110020313133100112
2333311230113102221000323322
1 3 0 1 1 1 1 1 2 0 2 1 1 3 3 2 0 3 1 0 2 3 3 0 0 3 2 0
0  3  2  0  1  2  1  0  1  0  2  0  2  2  3  2  2  0  0  0  1  1  1  0  3  0  1  2
3  2  3  3  3  2  1  3  3  2  3  1  2  1  3  0  2  0  2  2  0  3  1  2  1  0  3  0
3  2  0  3  1  3  0  2  1  3  0  2  1  1  3  3  3  0  2  3  3  3  2  3  3  1  2  0
2323000331202212030112300030
1 0 1 3 2 1 3 0 1 3 2 3 0 2 1 0 3 1 0 3 1 0 0 1 2 3 0 0
3  3  1  1  0  0  0  0  3  0  2  0  1  1  0  3  3  0  2  1  3  1  2  1  1  1  1  2
1  3  0  1  1  0  3  1  2  2  1  3  0  2  1  3  3  0  1  3  2  1  2  1  1  1  2  2
1 2 2 2 1 1 2 2 3 3 3 2 1 0 2 1 0 0 1 1 2 2 2 0 1 2 0 0
1 0 0 0 2 1 0 3 0 0 3 0 1 2 1 1 1 1 3 3 0 3 2 1 3 3 0 0
1030322011121223223300220200
3 1 0 2 2 3 2 2 0 2 3 3 0 1 0 3 0 3 1 3 2 1 1 1 3 1 1 0
3 1 1 3 3 0 2 0 2 0 3 0 3 1 2 3 2 2 2 1 2 3 1 1 2 3 1 2
0  2  1  2  1  3  2  3  0  2  2  1  3  3  3  1  1  2  2  2  1  0  3  3  1  3  1  0
0 0 2 3 2 0 2 2 0 2 1 2 0 3 2 0 2 0 2 2 2 2 1 1 3 3 2 2
2  1  2  3  3  1  0  0  2  0  2  0  1  1  1  2  0  3  0  0  0  0  0  0  3  3  0  2
1  0  1  0  0  0  0  1  1  1  0  3  0  0  0  3  3  2  0  3  0  3  1  0  2  1  0  2
2112132030320101212121112002
3  0  3  3  2  3  3  1  0  2  0  0  3  1  2  0  1  0  1  0  0  3  3  2  2  1  2  0
2  2  1  3  1  1  3  2  0  2  2  0  2  2  0  2  0  0  2  2  3  1  2  2  1  0  1  2
2  1  0  3  3  1  3  1  0  3  1  3  1  0  2  1  0  1  2  2  2  1  3  2  0  1  2  0
1123203300013030101301110332
2200310033323332030013312032
1010110110001100001100001000
