1 2 0 3 2 3 1 0 3 0 3 1 0 3 3 2 3 3 3 1 2
213202123031302231202
3 0 2 2 0 1 0 0 2 1 1 3 1 0 2 1 3 2 3 3 2
1  2  0  0  2  3  0  3  0  2  1  1  0  0  2  3  2  0  3  3  0
3  1  3  3  2  1  0  0  2  2  3  1  0  3  0  1  0  2  2  3  0
1  0  1  3  3  1  0  0  0  3  0  1  2  1  3  0  3  1  3  0  2
000000322230211030312
1  3  2  0  1  0  1  0  2  3  2  1  3  3  2  0  1  1  0  2  2
120102020100012232102
3  0  3  1  1  3  2  2  2  2  3  0  3  3  2  1  2  3  0  3  2
3  0  3  0  3  3  0  0  2  1  0  3  0  3  2  0  0  0  0  3  0
1 3 1 1 2 0 1 1 3 2 3 2 0 0 0 1 0 2 0 2 0
2 1 2 1 1 0 2 3 0 0 0 0 3 1 0 0 3 0 1 1 2
211002113333013013220
0 0 3 3 0 2 0 0 1 1 0 0 0 2 2 1 3 2 2 0 0
0  1  0  3  3  1  0  0  0  2  1  3  1  1  1  2  1  0  1  3  0
3 1 1 0 3 3 3 1 3 2 3 1 0 3 3 1 2 1 2 1 0
2 0 2 1 0 1 3 0 1 1 1 1 3 2 0 3 1 0 1 2 0
330330120333332131132
101332023330230313032
2  3  0  0  3  3  1  3  2  0  3  3  2  0  2  2  2  3  2  2  0
0 0 2 1 2 3 1 3 3 0 1 2 2 1 0 0 0 0 1 2 2
2  3  1  3  3  2  1  1  3  0  0  0  0  0  3  2  1  0  1  1  2
322132112223012113300
1 2 0 3 3 2 1 0 0 1 1 0 0 2 2 1 1 3 2 1 2
0  0  0  3  3  3  3  2  2  1  0  1  2  1  3  0  0  1  3  0  2
000101011111010011110
