332113033201310312002
0 0 0 0 2 3 0 0 1 3 0 2 3 1 1 3 3 1 1 0 2
011101121103033320120
2 1 3 3 0 0 2 0 0 0 2 2 2 3 1 0 3 0 2 0 0
0 3 1 0 3 0 2 3 2 2 0 1 0 0 0 1 1 0 3 0 0
0  0  0  1  3  1  2  0  0  1  2  2  1  3  1  0  2  0  1  1  0
2 0 2 1 0 2 2 0 3 1 0 2 2 1 2 2 0 3 0 0 2
302133131233233320012
323303100112020321120
3 0 0 0 1 2 3 3 0 0 0 1 2 2 1 1 0 3 2 2 2
2 3 0 1 3 2 0 0 2 1 0 0 1 1 2 0 0 1 0 2 0
3  3  2  2  0  3  1  3  1  2  2  2  0  0  3  3  3  3  2  1  2
032232130120313211102
1  1  0  0  1  0  1  0  1  1  0  1  1  1  0  0  0  1  0  1  0
