3 1 2 0 0 3 2 1 2 0 2 2 1 1 1 2 1 2 0 0 0 2
2 3 3 2 0 2 1 3 3 0 2 3 2 2 0 0 1 2 1 3 1 0
3013013201230123012120
1 2 1 0 3 2 0 2 2 0 0 0 3 1 1 3 0 1 2 0 1 0
1 2 0 2 3 2 2 2 3 0 0 1 2 0 2 0 3 1 1 1 0 0
0230222221100022002030
0  2  3  2  3  0  1  1  1  0  3  0  0  2  2  2  1  0  3  3  1  2
1 0 1 3 0 3 3 2 1 1 3 1 1 2 1 2 1 2 1 2 3 2
0110011020031032321002
2  3  1  0  1  0  1  2  0  3  2  0  2  3  0  0  3  2  0  0  1  2
0 2 0 2 2 2 0 0 0 0 0 0 2 2 0 3 0 3 1 1 0 2
2020212110230030100202
0 2 3 3 1 3 1 2 2 2 0 0 3 2 0 1 3 1 2 3 0 2
2  1  2  3  0  2  3  2  0  0  1  0  0  1  1  0  0  2  2  3  2  0
3203220332123211001020
2  0  3  1  2  1  0  3  3  3  2  2  3  3  3  1  1  3  3  2  1  2
0  3  0  0  3  1  0  0  2  3  2  2  1  2  0  0  0  1  1  0  2  0
0212323233223130010200
3  1  1  1  3  2  2  0  3  0  2  2  1  0  1  0  3  0  2  1  2  0
1  2  3  0  0  3  1  2  3  2  3  0  3  2  2  3  0  3  3  1  0  2
3  2  0  1  0  3  2  0  3  2  3  3  3  1  3  2  3  0  2  3  2  0
2  0  3  3  1  0  0  3  3  1  0  0  3  1  3  1  0  3  0  2  3  0
0 1 3 3 2 2 3 1 2 2 3 3 3 2 3 0 0 0 1 2 0 0
0 2 2 0 0 0 0 0 2 2 1 2 1 1 0 2 1 0 3 3 0 2
2 2 2 1 2 3 0 3 1 1 2 3 0 0 0 3 1 0 1 1 2 0
2 3 1 1 1 1 2 2 0 1 0 1 2 2 0 0 1 3 1 3 0 2
0  0  3  2  1  3  0  0  2  2  1  0  1  2  3  2  0  2  2  1  2  2
3333232020030002111030
3332303130302212322102
3001002333201001001302
0  1  1  0  1  0  0  1  0  1  0  1  0  0  0  0  0  1  1  0  1  0
