0  0  0  1  3  2  3  2  0  3  3  3  2  1  1  0  1  0  0  0  0  2  2  3  3  2  3  0  3  1  2  2  2  1  3  0
0 1 3 3 3 2 2 2 1 2 2 1 2 0 1 1 0 2 2 3 1 3 3 2 3 3 1 0 1 2 1 2 3 0 3 0
0 0 2 0 3 3 0 0 3 0 3 0 3 2 3 3 2 2 3 2 1 3 3 0 3 3 3 0 3 0 0 0 1 0 2 0
301031310003121220232301223002131232
330333300301300333223232120332122022
223023222213210102313310323133132300
232013211322213103311010020221102132
003203301013030113311022301113302332
3 0 0 0 3 2 2 1 2 1 3 2 3 1 1 0 2 0 3 0 0 2 3 3 2 2 3 3 2 3 1 3 2 2 2 0
3 3 0 0 2 0 3 0 2 1 2 3 2 3 2 1 3 2 1 2 3 3 0 1 3 2 3 0 2 0 1 0 1 2 2 0
101203323231333110110232311333312210
2  2  1  3  1  2  1  0  2  3  2  1  0  2  3  3  0  1  3  2  1  1  1  3  3  2  0  3  1  0  2  2  1  2  3  0
2  1  2  0  0  3  2  2  2  1  1  1  0  0  0  2  0  0  2  2  1  0  2  3  1  1  3  1  0  2  3  0  0  3  2  2
1  1  2  2  0  2  2  3  3  3  0  1  2  2  3  3  1  1  2  3  3  1  1  1  0  0  1  2  2  1  0  0  1  2  3  0
232121201001232213021021003323322102
2  3  1  3  3  2  2  1  1  2  1  1  2  3  3  3  1  0  1  0  1  1  1  3  3  3  1  1  1  2  2  0  1  0  1  0
1  0  1  1  3  1  3  1  3  0  2  3  2  3  2  1  2  0  1  2  0  1  0  3  3  1  3  2  1  3  3  3  3  2  2  0
330303130031212301012133012203002122
0 0 0 1 3 0 3 2 0 1 3 3 0 3 3 2 0 3 0 2 2 0 2 3 0 0 2 1 1 1 2 0 1 0 2 2
0  3  0  2  0  1  1  1  3  1  1  3  3  3  1  1  0  1  2  1  1  0  1  3  3  0  1  1  2  1  0  1  2  2  2  0
3  0  0  3  1  0  0  0  1  3  2  1  2  1  2  1  1  1  3  2  3  0  3  1  2  1  3  0  2  3  3  2  0  1  3  2
2  3  1  0  0  3  3  3  0  3  1  3  2  3  1  3  3  1  0  2  0  3  0  0  2  0  3  3  0  0  1  0  2  2  1  2
110000100011101001111011010010011110
