1  2  1  0  1  1  0  3  1  0  3  2  1  2  3  0  2  2  1  1  1  1  0  1  2  1  0  0  0  3  2  1  0  1  0  2
210213120130002310113130322023211220
123213012022233333232001013003030022
1  1  3  0  1  2  2  2  2  1  3  1  0  3  2  1  2  2  0  3  3  3  0  1  2  3  2  3  3  2  2  1  3  2  3  2
0  1  3  2  3  0  3  1  2  2  3  3  3  1  3  3  0  0  2  2  0  1  2  0  3  3  2  2  3  3  1  1  0  1  3  2
0 0 2 3 1 0 2 1 1 3 1 2 3 2 1 3 3 2 3 3 2 2 1 2 3 0 3 3 2 1 0 0 3 0 1 2
1 1 3 0 1 3 3 1 1 1 2 3 3 3 2 2 2 2 2 0 3 1 0 1 0 3 3 2 2 0 0 2 3 2 2 0
0  2  0  0  3  1  0  3  3  2  1  1  1  3  3  2  3  1  1  1  1  3  2  1  2  0  2  2  1  3  2  2  1  2  0  2
3 1 2 1 2 3 1 1 0 2 0 2 2 1 1 1 2 3 3 3 0 1 0 2 0 2 1 0 0 2 0 3 2 1 1 0
033202232022130300121203010112310200
1 1 1 2 2 0 0 3 1 2 2 3 0 3 2 3 0 3 3 2 0 2 3 0 1 3 3 1 2 3 3 0 1 0 2 0
001131020231033001220100023111010030
1  3  0  2  2  3  2  2  1  1  2  3  1  2  1  1  0  3  2  1  3  2  3  0  1  2  0  3  3  3  2  2  3  1  1  2
0 1 3 0 1 0 2 2 2 2 2 1 2 3 3 3 3 0 2 2 2 3 3 2 0 3 1 3 0 0 2 1 0 3 3 2
2  2  2  1  0  2  1  1  2  3  3  0  0  1  1  0  0  1  3  2  2  2  1  0  0  3  3  3  0  1  1  1  1  3  1  2
0 0 3 0 2 3 1 2 3 1 0 3 2 3 0 0 2 0 2 0 0 0 0 2 2 3 2 2 1 3 2 0 0 1 0 2
2  1  2  1  2  0  0  0  0  0  1  2  1  1  3  0  3  3  1  2  2  2  3  3  0  3  1  3  3  1  3  2  0  0  1  2
0  0  0  0  1  1  1  1  0  1  0  0  0  0  1  0  1  1  0  0  1  1  0  1  0  0  1  1  1  0  1  1  1  1  1  0
