1 0 0 2 0 2 3 0 0 2 0 3 2 0 0 0 2 0 0 1 3 1 2
3 0 0 1 1 0 1 1 1 0 3 2 2 2 1 0 2 2 0 2 3 1 0
3  1  1  0  2  1  0  2  0  1  2  0  0  1  0  1  3  0  2  2  3  0  2
13323323320312013133130
3  3  2  1  2  3  1  2  0  2  3  1  2  3  2  0  3  1  1  1  1  1  0
00311002323010200332122
22022020333300200022010
13233001121300020320230
0 0 1 0 1 0 0 1 1 0 1 1 1 1 1 1 1 0 1 0 0 0 0
