32331212332023321222132132202222
01330321011213300010012133101032
0  2  2  3  2  1  0  0  0  0  2  2  3  3  3  1  2  1  3  1  3  2  1  1  0  1  2  0  2  1  3  2
02122210210133200113212011311300
22211233232113012102223102110310
1 3 3 1 0 2 2 0 0 1 1 0 3 3 1 2 2 1 3 3 2 2 3 0 2 3 2 1 3 0 3 0
2 3 2 0 0 0 1 3 2 1 3 3 1 1 2 0 3 0 1 3 2 0 0 2 3 3 0 2 3 0 2 2
10213311331222200322330103002102
33302002332302002311103210301132
30121313000131111310132233020232
3  0  3  3  3  2  2  1  1  0  3  2  2  3  0  3  1  1  0  2  3  2  2  1  3  2  1  0  2  3  0  0
2 0 2 0 0 0 0 3 1 2 0 1 1 3 1 2 0 2 3 1 3 2 2 2 1 2 2 1 0 3 0 0
0 2 3 1 1 1 3 2 2 3 1 3 1 0 0 1 2 1 0 0 3 0 1 3 3 3 0 1 1 1 1 0
1 3 3 1 2 0 1 1 3 1 1 1 0 0 0 2 0 1 3 3 3 3 2 1 2 3 0 1 2 1 2 0
03112121110220223223222203301122
01111102010302030122131021310330
11101001100101011011101110011100
