112123110
2 2 0 1 1 3 3 2 0
1 2 3 3 1 0 2 3 2
2 1 0 2 2 0 0 2 0
2 3 1 1 3 2 3 2 0
2 2 1 3 1 2 3 1 2
0  0  3  3  1  1  3  0  0
231031132
333302212
3 3 0 3 2 1 2 2 0
1 0 0 0 2 2 3 2 2
2  1  2  0  2  0  3  0  2
200121022
210032110
2  1  2  1  3  3  3  0  2
1 0 2 0 2 1 1 0 0
0  0  3  2  0  0  2  3  2
3  1  3  3  3  1  3  3  2
313011020
3  1  2  0  0  0  3  1  0
320221100
2 0 1 3 3 0 1 2 2
0  0  1  3  0  3  1  0  0
1  3  2  1  1  2  3  0  0
002102200
120023132
0 3 0 1 0 1 1 0 0
310312112
2  1  3  2  3  1  0  2  0
1  3  3  3  2  1  1  1  0
1  1  0  1  0  1  1  0  0
