2  1  1  1  2  2  3  3  1  2  2  0  2  3  0  3  3  1  2  3  1  0  1  3  0  1  1  1  0  1  0  2  1  3  1  0  0  3  1  3  2
1 3 3 0 1 0 2 3 0 3 0 1 2 0 2 2 0 1 0 2 1 0 2 0 3 3 0 0 1 3 2 0 2 0 3 0 1 3 1 3 2
23033331333022210300312001021122211333030
1 0 1 1 3 2 2 0 3 0 0 0 3 0 1 1 2 0 2 0 0 2 1 0 0 0 0 2 3 3 1 0 0 3 2 1 2 2 1 2 0
2  1  2  3  0  1  3  1  3  0  2  1  3  2  1  1  3  0  3  0  2  3  0  1  0  1  3  2  3  0  1  1  2  3  0  2  3  1  3  3  0
0  1  1  1  3  2  0  3  1  1  3  2  0  2  3  0  2  1  2  3  1  2  2  2  3  1  1  2  3  0  2  2  3  0  1  3  3  0  2  3  0
1  1  1  0  0  2  3  3  2  3  1  0  2  2  1  0  1  0  0  1  0  1  0  0  1  3  1  0  2  0  2  2  1  0  1  1  1  1  2  1  0
1 2 3 0 2 1 2 3 2 0 3 2 1 3 3 1 2 1 1 0 3 2 2 2 2 0 2 3 0 1 0 3 3 0 2 0 2 1 2 2 0
3  3  1  3  2  2  3  3  2  1  3  0  3  3  3  3  0  0  1  3  3  0  3  2  3  3  1  0  3  2  0  0  2  0  0  3  2  3  3  2  2
13211322211002331033123232323132020221030
2 3 3 2 0 0 3 1 0 2 3 2 3 1 1 3 0 1 3 1 0 1 1 3 2 1 1 1 1 1 1 2 2 0 3 0 0 1 0 0 2
30212032222030032331332303221200101131210
10023002022133120022132202010012013022330
2  2  3  3  3  0  3  1  3  1  1  3  2  2  1  1  2  2  3  3  0  3  1  2  3  0  3  3  0  1  0  3  0  2  1  3  0  0  1  1  0
1 0 2 1 0 1 3 0 1 0 2 2 2 2 2 2 1 2 3 2 1 3 3 0 1 2 0 1 1 0 2 1 2 0 3 3 2 3 0 0 0
3  0  1  3  3  1  2  1  0  2  3  3  1  0  0  0  3  0  3  3  0  1  1  1  1  3  3  0  0  1  3  1  1  3  3  0  2  0  0  3  2
0 3 2 1 2 1 3 2 0 0 2 1 3 1 2 3 1 1 3 0 2 1 2 2 2 0 1 3 2 2 1 0 2 3 0 0 1 3 0 1 2
0 1 1 0 1 0 0 1 1 0 0 1 1 1 0 0 0 0 0 0 0 1 1 0 0 0 0 1 1 1 1 0 0 1 1 1 0 1 0 0 0
