1200130110
0  0  1  1  1  0  2  0  3  2
1033302200
1  1  1  2  3  3  0  1  0  0
3  0  0  1  0  2  2  0  0  2
0 3 3 3 1 1 3 1 0 2
2320212100
1  2  3  0  0  1  0  2  2  2
3 0 3 3 3 0 1 0 1 2
1111000130
2231012320
1332230002
3332310132
1302122002
2  2  2  1  0  3  1  1  2  0
1 1 3 1 0 2 3 3 2 2
3102032312
1031213222
1  1  3  0  0  2  0  1  1  2
2020100100
0 1 3 2 1 0 2 2 2 0
1  2  1  3  3  3  0  3  3  2
1101110000
