2  0  3  0  0  2  3  0  2  1  1  1  0  1  3  3  3  2
2 0 1 3 0 1 1 1 1 2 1 2 2 3 0 0 0 2
001223301031102330
2 0 3 3 1 0 0 3 3 1 1 3 1 3 2 3 0 2
3  1  1  2  1  1  3  1  2  1  3  3  3  2  0  0  1  2
212313031003002322
302003231021002032
3  0  3  0  2  0  1  0  2  1  2  1  3  0  2  2  1  2
3  0  3  0  2  1  1  1  0  1  3  3  3  3  2  1  2  2
2 0 2 1 0 1 3 0 3 2 1 3 0 0 1 0 2 0
0 3 0 0 2 1 0 1 1 1 2 0 3 3 2 1 3 0
123223230100232102
2  3  1  3  1  0  2  3  1  1  3  1  2  1  1  0  3  2
3 0 2 0 0 1 0 0 1 3 1 0 0 2 3 0 0 0
023033022132302112
2  2  0  2  1  0  1  2  1  3  2  0  2  0  0  3  3  0
1 3 3 2 2 2 0 1 1 3 1 2 1 3 2 2 0 0
222121121201000312
111222121031333012
0 2 0 1 2 1 3 1 0 1 2 2 2 1 2 1 1 2
220231232221121302
001202011123010200
1 0 2 3 3 2 0 1 2 1 3 0 1 2 1 2 1 0
0  2  2  0  2  2  1  1  0  1  3  0  3  1  0  1  2  2
1 2 2 1 1 3 3 2 3 3 1 2 1 1 3 1 0 0
2  3  1  0  1  0  2  3  1  1  1  1  2  0  2  0  0  2
100320023213313212
101001100000011100
