3  1  0  0  0  0  3  3  2  2  1  0  2  3  2  1  0  0  1  2  3  0  1  0  1  0  0  1  0  3  2  1  0  2
1  0  0  2  1  0  1  0  2  2  3  1  0  1  2  3  0  3  1  2  3  1  0  1  1  0  0  1  1  2  2  1  2  2
2  1  3  1  2  2  1  2  3  1  0  1  1  3  0  3  2  3  0  2  0  1  3  2  2  0  3  0  2  1  3  1  1  2
2  0  3  2  0  1  2  0  3  0  2  3  3  2  1  0  2  2  3  3  3  2  2  3  1  0  3  1  1  2  0  2  2  0
0  0  2  2  2  0  0  1  3  3  0  1  3  1  2  0  3  1  1  0  1  1  0  0  0  2  1  3  0  2  2  0  2  0
3 0 2 2 3 0 0 3 1 3 3 3 1 1 0 2 2 3 3 1 2 0 1 0 1 1 0 0 1 0 3 2 0 2
3  1  0  2  3  0  0  2  3  1  3  0  3  0  2  3  3  0  3  0  1  2  2  0  3  0  0  1  0  1  0  2  0  0
2223303120231032332332003030310110
3 3 1 1 0 0 3 2 0 3 0 0 2 0 1 2 0 1 2 0 2 2 2 2 3 0 2 3 2 2 1 2 3 0
1  0  0  1  1  0  2  1  3  1  3  0  2  3  0  3  0  2  2  2  3  3  0  1  3  2  1  1  2  1  3  1  2  0
3 0 2 1 0 3 3 2 0 1 0 0 2 2 2 2 2 3 2 2 3 1 3 1 0 2 3 3 3 2 1 2 1 2
1200033302311203221010303332020222
3  2  2  0  3  0  2  1  3  2  0  2  3  3  0  2  3  2  1  2  3  0  1  0  0  0  2  3  3  3  1  3  3  2
0013201220100123211301102110020122
3113332033301010012320032213202330
0  3  1  2  3  3  3  3  1  1  3  0  0  1  0  2  1  0  2  3  0  1  0  2  1  1  1  2  0  3  2  2  0  0
3313331203213320101011233100201230
0  3  0  3  2  1  1  0  3  3  2  1  0  3  1  0  0  3  3  3  0  3  0  3  1  0  1  0  0  2  1  0  3  2
2  2  2  0  2  2  2  3  2  0  2  0  3  2  0  0  3  3  2  0  2  1  1  1  1  3  0  1  1  0  1  2  0  0
0220101030212311103220002030010222
3 1 3 2 2 3 3 2 2 3 3 0 2 2 3 1 1 3 3 3 2 3 3 2 3 1 0 0 1 3 3 3 1 2
3 2 0 1 0 2 1 1 2 0 3 3 3 2 3 1 1 3 3 0 3 1 3 0 3 3 1 0 3 1 1 1 2 0
0010011100100000010110010000000110
