3  3  0  1  2  3  0  1  0  1  1  1  3  2  2  2  0  0  3  1  2  2  1  3  1  1  3  3  1  3  0  0  0  0  0  1  0
1322133320220132123012312103300110122
0 0 3 2 0 0 2 1 2 0 2 0 2 0 0 3 3 1 3 3 2 0 2 1 1 1 1 3 2 1 2 2 3 0 1 3 2
2213023032031001022233231202221210022
1  1  3  1  0  1  3  3  2  1  0  0  0  2  0  1  3  3  2  3  3  2  0  1  2  3  0  2  1  3  1  3  3  2  0  1  2
3  3  2  3  0  0  1  3  2  2  0  3  2  0  3  2  2  0  0  2  2  2  1  1  3  1  3  2  1  2  1  2  1  3  1  1  0
1 3 1 1 1 0 3 2 0 2 1 0 0 0 0 1 3 1 2 0 1 2 2 3 3 2 1 0 1 0 1 1 0 1 1 2 0
3  3  0  0  3  2  1  2  1  2  0  1  2  3  2  1  1  0  3  2  2  0  0  0  1  1  0  0  0  0  0  2  2  3  3  3  0
3  3  3  3  2  0  1  1  2  0  1  1  3  3  3  0  3  1  3  0  2  1  3  1  3  1  1  0  3  1  0  3  0  3  3  3  0
0 0 1 0 0 2 0 1 3 0 0 3 3 2 2 0 3 3 2 2 2 2 1 0 2 1 2 2 3 2 1 0 0 3 0 3 2
1 1 0 2 0 2 0 1 0 2 3 3 2 2 0 0 0 1 3 0 2 2 0 1 0 2 3 0 0 3 1 1 2 2 0 3 0
1132013003111021201132232023232222100
0 2 1 2 1 3 0 0 0 3 3 1 3 0 3 2 1 1 3 1 1 0 2 2 0 3 2 3 3 2 0 3 1 1 1 0 0
3032103202330111303120300333031131032
1 3 3 3 2 2 0 2 1 3 1 0 3 2 0 2 1 1 3 2 0 1 2 2 0 0 1 1 2 3 1 1 3 0 0 1 2
3  0  2  0  0  3  0  1  3  0  1  2  0  1  2  0  1  1  0  2  2  1  3  2  0  0  0  2  3  3  1  2  1  1  0  3  2
1310311023133022020231220113323213302
3121130112001031130012110301100331212
3012113333211303231010222013322131000
0  1  1  1  1  1  1  1  1  1  1  1  0  1  0  0  1  0  0  0  0  0  0  1  0  0  0  1  1  0  1  0  0  1  0  1  0
