00112301332
22020301220
1  3  1  3  1  1  0  2  2  3  0
30112033010
0  2  0  0  0  2  1  3  3  1  0
21331232110
2  2  2  0  0  0  3  0  1  0  2
2 1 3 2 2 1 2 3 3 1 0
1  0  1  0  3  0  2  2  1  3  2
22331010222
22323323302
1 0 1 0 2 1 3 0 1 0 0
3 1 3 3 2 3 0 3 2 3 0
0  2  2  0  2  2  0  1  0  0  2
1  2  2  3  2  1  2  1  3  2  0
12023030130
1  1  0  0  0  1  1  1  0  1  0
