211203010212003322221232231020311021010
0 3 0 3 1 1 0 2 0 3 3 3 1 1 2 3 3 2 0 0 1 2 3 3 0 2 3 3 2 1 3 2 0 2 0 1 1 3 0
2  3  2  3  2  0  2  2  0  2  0  3  1  0  2  2  1  1  3  1  2  1  3  2  0  2  2  1  3  0  3  0  2  2  1  0  0  2  2
3  0  0  2  2  0  2  1  0  2  0  1  1  3  3  1  3  2  2  0  3  3  3  0  1  3  1  0  1  1  2  1  2  1  2  1  2  1  0
1  2  2  1  2  1  3  3  0  0  3  0  0  0  2  2  0  1  2  1  2  3  3  2  0  0  3  1  3  3  2  0  3  2  2  2  2  1  0
1 0 1 0 0 3 3 1 0 3 1 0 3 1 3 1 0 3 3 0 1 1 3 3 0 2 0 0 3 2 2 1 1 2 1 2 0 1 2
031001333313032303233320323331010021332
3  3  1  0  0  3  1  2  2  3  1  0  2  3  0  0  2  0  1  2  1  1  3  1  2  3  1  3  0  3  3  2  0  1  2  3  0  2  2
133333001232213100000300101310000100232
2 0 1 1 2 2 1 0 2 2 3 3 0 1 2 3 0 3 3 1 1 2 0 0 2 2 2 0 1 1 2 3 2 2 0 2 1 0 0
3 0 0 2 1 1 2 1 3 1 2 0 1 3 0 1 2 3 1 1 1 2 0 1 3 0 3 1 3 1 0 2 3 2 1 0 0 1 2
0  2  2  0  0  1  2  3  2  3  1  2  2  3  1  3  1  3  3  2  3  3  0  2  2  3  2  3  3  1  0  1  0  1  0  3  3  0  0
0  3  1  2  1  2  0  0  3  0  3  3  3  0  3  3  0  3  1  1  3  0  3  0  1  0  1  1  1  1  1  1  3  1  1  0  2  3  0
133331212332300120101031303221103123102
2  1  0  3  3  2  1  2  0  1  1  0  0  2  3  2  1  3  1  3  1  0  1  2  1  1  1  3  0  2  1  3  2  3  0  2  0  2  2
3 1 2 3 0 2 0 3 0 1 1 3 1 2 1 0 1 3 3 3 0 2 0 2 3 0 1 0 3 2 3 1 1 3 2 3 3 1 2
333331020212320221003112312131113132210
222113201131233003013101231001301122312
301012030000013303320311213032113333302
011313203022132001010322311110212313230
1 0 1 2 2 2 1 2 0 3 3 3 3 2 3 2 1 2 3 1 0 2 3 0 3 1 3 3 1 0 0 3 3 2 3 1 0 2 0
232211332310232303222030021110121013122
011323133020311012211203031221333103000
3  1  0  3  2  0  0  0  0  2  3  3  3  0  1  1  1  0  2  0  2  0  3  2  0  2  0  0  1  2  0  1  2  1  3  2  1  0  2
2 1 0 3 3 2 2 2 2 1 2 3 2 3 3 2 1 2 2 1 3 0 3 3 3 3 0 1 1 2 3 2 2 3 3 2 0 2 2
2 1 3 0 3 2 3 1 3 3 2 1 3 2 2 3 1 0 2 3 1 0 0 3 3 1 1 2 1 3 2 0 0 1 2 1 3 2 0
2 2 2 3 1 1 1 1 0 2 1 2 0 1 2 0 1 2 3 2 1 1 1 2 1 0 0 3 2 3 2 2 3 3 0 0 2 2 0
2 2 1 2 1 2 3 0 3 0 3 1 1 3 0 0 3 2 0 0 3 0 2 3 2 2 1 3 3 2 1 2 2 0 2 2 0 3 0
3  3  1  3  3  0  3  2  1  1  1  2  3  2  3  2  1  2  1  0  3  1  1  2  0  0  0  0  2  2  2  2  2  3  3  1  0  0  2
1  1  0  3  1  2  1  1  3  3  1  3  1  1  1  1  3  3  1  1  0  0  2  2  3  1  2  3  3  3  2  2  3  3  2  0  3  0  0
000001110101111011101010100011001101100
