0 2 3 2 3 0 3 2 1 1 1 1 3 3 3 1 2 2 0 1 0 1 0 0 2 2 3 0 2 1 0 1 0 1 2 2 0 0 2 0 2
0  1  2  0  2  2  3  1  0  0  1  2  2  1  0  0  0  0  3  1  0  2  1  0  3  3  2  3  3  2  0  1  2  1  0  3  2  1  3  2  2
0 1 2 0 2 1 3 2 2 1 1 2 2 0 3 1 3 2 1 0 0 2 1 3 0 2 0 2 3 3 2 0 1 0 3 0 0 3 3 0 2
3  0  2  1  0  1  1  1  2  0  1  2  3  1  2  0  2  3  2  1  2  2  2  0  1  2  0  1  3  3  3  2  1  0  3  0  3  0  0  1  0
3 2 3 0 2 3 1 3 0 3 3 2 3 0 2 0 1 1 2 1 2 1 0 2 2 1 1 0 1 2 2 0 1 2 1 0 0 3 1 3 0
2 3 0 2 0 2 2 0 0 1 2 1 1 0 0 2 3 1 2 2 3 2 0 2 0 2 3 0 1 1 1 0 0 0 3 3 2 3 1 3 2
20233110103032222010301211012200302312002
3 3 0 3 3 3 1 1 3 2 0 2 3 1 3 2 1 3 2 1 2 0 3 1 1 2 1 1 3 1 2 3 0 2 1 3 1 3 3 2 0
3  0  2  3  2  3  0  1  3  3  3  2  2  1  2  0  2  3  0  0  2  0  2  0  1  1  0  0  1  2  0  0  1  3  2  1  0  2  1  0  0
03200012313210233112000321312331131031330
0  2  2  2  2  3  2  2  0  2  3  1  3  2  0  0  1  0  0  3  0  3  3  0  2  3  2  0  3  1  1  3  2  2  0  2  3  2  1  2  0
03010220021301001330132033121200220321010
3 0 3 0 2 0 1 1 2 1 3 1 0 1 1 3 0 3 1 2 0 2 3 1 0 2 2 0 0 0 3 1 1 2 3 0 2 2 0 2 0
2 0 2 3 2 3 2 2 3 3 0 0 3 2 0 1 1 1 3 3 0 2 1 1 3 1 0 3 2 1 1 1 1 2 3 3 1 0 0 1 2
1 1 1 0 1 1 0 0 0 2 2 1 3 3 1 3 1 1 0 1 3 3 0 2 1 0 2 2 3 0 1 2 3 2 2 2 1 2 2 1 2
3  0  1  2  0  3  0  2  2  1  2  0  2  1  0  3  1  1  3  3  2  1  1  2  2  0  1  3  3  0  3  3  3  0  2  1  0  2  2  2  2
1  2  2  3  2  3  3  3  2  1  0  2  2  2  3  3  1  1  3  0  3  2  0  1  2  2  2  3  2  1  1  3  1  2  0  3  3  1  1  2  2
0  0  3  1  0  1  1  0  3  2  3  3  1  2  2  0  1  3  3  0  0  0  3  3  0  0  3  1  2  1  3  3  3  3  0  0  1  0  2  3  0
01322200012132321103310210131211113211132
0  0  0  1  1  1  1  1  0  1  1  1  1  1  1  1  1  1  0  0  1  0  0  0  1  0  1  0  0  1  1  0  0  0  0  0  1  0  0  0  0
