33011330332200320123323312
23333231203320300222120122
02130032331313232112302022
30231230113012211031320332
0 3 3 1 1 3 0 2 0 1 2 2 0 2 0 1 0 2 3 1 1 1 0 3 0 2
32201332212030230212322300
02011212033033011231310212
3 3 3 0 1 2 3 3 3 2 3 2 3 3 0 0 3 2 0 2 3 3 3 0 1 0
3 3 0 1 2 3 2 2 1 0 0 1 3 2 2 1 1 2 0 1 1 1 2 3 1 0
0 2 0 2 0 1 3 1 0 0 2 3 2 3 1 2 3 0 1 2 3 2 3 2 1 0
2  3  0  1  2  2  2  0  3  1  3  1  3  2  1  0  1  2  1  2  2  2  0  0  3  0
32110030300300310230001112
1  2  1  3  2  1  2  3  1  1  2  1  2  1  0  0  2  3  1  2  2  2  2  2  2  0
2  2  2  0  1  1  0  2  1  0  1  0  0  3  3  2  0  3  0  1  1  0  3  2  3  2
23030123130132210231332100
1 0 0 3 0 0 1 0 0 3 3 0 2 2 2 3 2 2 3 2 0 2 1 2 0 0
2  1  1  3  0  0  0  2  2  1  0  1  1  2  0  1  2  3  0  2  3  1  2  3  0  2
0  2  3  1  2  0  3  2  1  2  1  2  2  1  3  2  1  3  0  2  2  3  3  1  0  0
0  1  0  1  0  0  1  1  0  1  0  0  0  0  1  0  1  1  0  1  0  1  0  0  1  0
