2 2 1 2 2 1 2 3 1 0 0 1 1 1 3 2 1 3 3 0 2 1 3 0 0 0
0  3  3  0  2  0  2  3  3  0  1  2  0  1  1  1  3  2  3  2  0  1  1  1  0  2
02212210011113033131210110
23131302102222230331130330
1  1  0  1  3  0  0  0  0  2  2  1  1  1  1  2  2  2  2  1  2  1  0  3  3  2
3  0  1  0  2  2  3  0  2  1  3  3  0  0  0  1  2  0  1  0  0  0  3  3  2  0
1  2  1  2  0  1  1  1  3  3  1  3  1  1  3  0  1  1  2  2  0  2  3  0  1  0
11000332321002303121031030
03033113231013333322233230
1 0 2 1 1 2 2 0 0 2 0 2 3 0 2 3 2 3 3 1 3 0 0 3 1 2
10111011110101000011100100
