33321030020212200100022202
2  1  0  0  1  0  0  3  3  2  3  3  0  2  0  1  2  2  0  0  2  2  1  3  2  0
1 0 0 0 3 0 2 0 1 0 3 1 1 1 3 0 2 2 3 2 1 1 3 0 2 0
0 0 0 1 3 0 3 1 0 2 2 1 2 0 2 0 3 1 2 0 0 0 1 2 0 0
2  0  2  3  2  1  3  2  3  3  3  1  1  3  1  3  1  2  2  3  0  0  1  3  1  2
3 2 2 0 1 3 1 0 0 1 2 3 1 3 0 0 2 1 2 2 3 1 2 2 1 0
01121211332313113220132330
01321310302201010311020202
12222312021310122221223202
3 0 1 2 1 2 3 3 2 0 1 3 0 1 3 3 3 3 2 1 0 3 3 3 3 0
3  3  2  2  1  2  1  2  1  1  1  0  1  0  2  2  2  1  3  1  2  2  2  1  1  0
1 1 3 2 2 3 2 3 2 2 0 2 0 1 0 2 1 1 2 0 3 0 2 0 1 2
1 0 0 0 0 1 1 1 1 0 0 1 1 1 0 1 1 1 0 0 1 1 1 1 0 0
