0  1  3  3  3  1  1  2  2  1  3  0  3  3  2  2  0  3  3  0  0  0  2  3  0  1  3  2  0  1  0  1  0  2  1  0  0
0 1 0 1 1 2 1 0 0 0 1 3 1 3 0 2 1 3 1 0 2 1 0 1 1 1 3 2 0 1 3 1 0 0 2 1 0
3  3  3  2  3  1  3  1  1  0  1  2  1  3  3  1  3  3  3  1  3  0  0  1  1  0  2  3  1  2  1  2  1  2  2  3  0
1031210101013032220023311022331021302
1 0 2 2 1 2 3 0 2 1 3 0 1 1 0 2 3 3 0 3 0 3 1 0 2 2 3 1 3 1 1 2 3 2 1 0 0
0  0  1  0  2  0  1  3  1  1  0  1  2  1  2  0  1  1  0  2  3  3  3  0  2  2  3  1  3  2  2  2  2  2  1  0  2
2022121320233020322001333221201221302
2020010120011030021230211001311133310
3212122012101333011231211032312022000
0010100100010101010011110111101101100
