2 1 2 0 0 0 2 3 0 2 2 1 1 2 1 3 2 0 0 3 3 2 0 0 0
1030321330101033300110222
3  3  0  1  1  3  0  2  3  3  1  1  3  3  0  1  3  2  3  0  2  0  0  1  0
2123302021310020011231302
1  0  3  1  1  0  1  3  3  0  0  2  3  2  3  3  0  2  3  2  2  0  2  1  0
2032221121333333210302332
0131222323203320332233222
3 0 2 3 0 2 0 3 1 3 1 1 3 0 2 0 1 1 0 1 3 2 3 0 2
3 0 0 3 1 2 3 1 1 2 3 1 2 1 1 3 3 1 2 3 2 0 2 1 2
1110003000201202121211010
0  2  3  0  3  0  1  0  3  2  0  0  3  0  2  2  3  3  2  1  0  3  0  1  0
3 0 1 0 1 3 3 2 3 3 3 3 2 3 0 0 2 2 0 0 0 2 3 0 2
2021122111330223213321230
3  2  0  1  1  1  2  2  2  1  2  1  1  3  3  2  0  2  2  1  3  3  3  0  2
3  1  2  2  1  3  3  3  2  2  1  3  1  0  1  0  0  3  2  0  1  1  0  1  0
0333233122301212232331122
1  1  3  1  3  0  2  3  2  1  2  1  0  3  2  3  1  2  2  1  1  3  3  0  0
1  1  3  2  1  2  0  3  3  1  2  1  2  1  3  0  0  0  1  0  3  0  3  1  2
1  3  2  3  0  1  1  2  3  0  2  1  3  0  3  0  3  3  3  0  2  3  1  3  0
0 3 2 3 3 0 3 3 1 3 0 2 3 2 2 3 2 1 2 3 0 3 0 0 0
2013111023211021023011130
0  0  0  3  0  1  3  0  3  2  1  0  2  2  3  0  3  1  3  3  1  2  3  0  2
0012233300332222201020332
0 0 0 0 0 3 0 0 3 0 0 2 2 1 2 0 3 2 0 0 1 2 1 0 0
0 0 3 0 1 3 2 3 1 2 3 2 0 0 2 1 2 2 0 2 0 3 3 2 2
3303203032212331110311310
3200323203020021111232312
2 0 1 3 1 0 2 0 1 1 2 0 1 3 3 0 3 2 3 2 3 1 0 1 2
1320322313233202032022210
2 3 1 3 0 1 2 0 3 1 0 2 2 2 2 3 3 1 0 0 0 3 1 1 2
0 1 0 1 0 0 1 1 0 1 1 0 0 0 0 0 1 1 1 1 1 1 0 1 0
