3130322013303230
1  0  3  1  3  0  3  2  0  0  2  0  1  2  1  0
2003103113230232
3 1 1 1 1 3 1 0 2 1 1 2 1 2 2 2
2 3 1 2 2 2 3 3 1 2 2 2 1 1 0 2
1  0  2  1  0  2  3  3  3  3  1  2  0  1  3  2
0011203012230332
1 1 0 0 2 0 1 2 2 1 2 3 1 3 3 2
0  2  1  2  1  2  1  2  1  2  2  1  1  0  1  2
2320222332223112
3  0  1  1  3  0  2  3  1  3  3  2  0  3  3  0
3010222133102312
1 3 0 0 1 1 2 3 0 3 0 3 3 1 1 0
1  1  3  2  2  3  2  0  0  2  1  0  0  0  1  0
2101302032303122
3  1  2  0  0  2  0  1  2  3  2  1  3  2  0  2
0220122310101112
2  3  3  0  3  2  3  1  1  3  2  0  2  3  1  0
2  1  1  3  1  3  1  0  0  1  2  0  3  0  0  0
1 3 0 2 3 3 3 0 2 3 1 1 3 3 0 2
0101312111220102
3  1  3  1  3  1  2  1  2  1  0  1  0  1  0  0
0  2  0  0  2  1  2  0  0  2  3  3  1  2  3  0
3  2  1  1  2  0  1  1  0  1  2  2  1  1  1  0
0 0 0 2 0 0 1 1 2 2 3 3 1 3 1 2
1  3  1  1  3  1  2  3  3  1  3  3  2  3  1  0
1112111103320330
1131322022113212
0100111000101100
