3333311230303033203200312112322313301210
3  3  1  1  0  1  3  2  2  2  3  3  0  2  2  1  3  2  3  3  0  2  2  1  0  0  1  2  3  3  1  0  3  2  1  2  2  3  2  2
0 0 3 3 1 2 0 3 3 2 3 3 0 1 1 1 2 1 0 3 3 2 2 2 1 1 3 3 2 1 2 0 2 3 0 1 1 3 3 2
3  1  2  1  3  3  3  1  0  1  3  0  3  1  3  3  3  3  0  2  0  1  3  1  1  1  0  3  2  3  0  2  1  1  0  0  0  2  3  2
2 2 3 3 1 1 2 3 1 3 1 2 0 2 0 2 3 2 2 0 0 0 3 1 3 1 0 0 1 2 3 0 1 0 2 0 3 2 3 0
3  1  3  2  0  3  1  2  3  2  1  3  3  0  0  1  3  2  3  2  2  2  1  0  3  0  3  1  0  1  3  0  3  1  1  2  0  1  0  2
2310020302210232222230222220000112003110
0  1  2  1  1  3  2  1  1  3  1  1  0  3  0  3  3  2  3  3  1  3  3  1  2  0  0  1  0  1  2  3  0  1  3  3  0  0  2  2
2000323303223021211321302223021311110020
3  0  3  3  1  0  1  2  1  2  3  1  2  3  3  0  2  2  2  2  1  2  2  0  2  2  2  2  3  1  3  0  3  0  1  0  1  3  1  2
0  2  0  1  2  1  1  1  1  3  2  3  1  2  1  1  2  0  3  2  0  2  0  3  2  0  3  1  2  0  3  3  0  0  3  3  3  0  3  2
3 1 1 0 3 2 0 1 3 1 1 1 0 3 0 3 0 0 1 3 0 2 0 2 2 0 3 3 0 0 3 3 2 2 0 3 3 0 1 2
1101033323001023001031022330031130221220
1331101203133122302231002221033221033000
3300301133112321002032120001123001320002
2 1 0 1 0 0 1 0 0 0 0 1 1 3 3 2 1 3 3 3 2 1 3 0 3 1 2 3 1 2 1 2 1 2 0 3 3 2 2 0
3200302311031231221322312313303110132120
3233231310222232032032203013320001121030
2 2 2 0 2 3 0 3 1 1 1 1 2 2 2 2 1 1 2 2 1 1 1 0 2 0 2 2 1 3 2 1 3 1 3 1 3 0 1 0
2 0 3 0 3 0 2 2 3 2 2 2 0 1 0 3 0 1 0 2 3 3 2 0 0 0 0 1 2 2 0 1 2 1 2 0 0 0 2 0
1  3  2  2  3  3  1  1  1  3  1  2  0  1  0  1  1  2  2  1  2  3  3  0  2  1  3  1  1  3  3  1  1  0  2  3  0  0  1  0
0100011011100011101010000010101000010010
