1 0 3 0 0 2 0 0
02021000
3  2  0  2  1  0  1  0
3 0 0 2 1 3 1 2
1 3 1 1 0 1 3 0
3 3 0 3 1 1 1 0
01030300
11331132
1  3  2  3  0  2  0  2
1  0  0  0  2  3  3  0
13202332
11230120
2 2 3 2 0 1 1 2
1 2 3 2 2 1 1 2
2  2  1  1  2  3  1  0
31101332
10101010
