2 0 3 1 3 2 2 1 1 2 3 1 1 2 2 1 1 3 3 0 0
3 1 0 0 3 3 1 1 1 0 3 3 1 3 3 2 1 0 2 0 2
030121303201332222100
1 3 3 2 2 3 1 1 1 3 1 1 0 0 3 0 1 0 0 2 0
201323131203312002212
3 1 3 0 2 0 1 1 1 3 2 0 0 3 2 0 2 2 3 0 0
311310233111011222322
000323113031231311230
011103232122300110310
122120313232333220132
311000130323102030212
011321120313102300020
132102221023030302220
230311301201012211300
3  3  1  0  3  0  3  3  1  2  2  0  2  1  2  0  3  2  1  3  2
320322301212301021030
131001302121311231030
231033130333133123002
2 2 1 3 2 0 1 1 2 3 1 2 0 2 3 0 0 3 2 3 2
1 0 1 3 2 1 0 1 1 3 1 0 3 3 0 2 3 0 0 0 0
2  1  1  1  2  1  1  3  0  0  1  3  2  3  2  0  1  2  1  3  0
0  0  2  3  1  2  0  2  0  0  3  0  0  3  3  1  2  2  0  2  2
2  1  0  1  2  1  3  3  0  2  2  0  2  0  3  3  1  3  2  1  2
0  2  2  3  3  2  0  3  3  1  0  2  3  3  0  3  1  3  0  0  0
110100111101101101100
