1  3  1  2  1  2  0  1  2  0  2  3  2  1  1  0  1  0  3  0  1  2
1 2 0 0 2 3 2 0 2 3 1 0 3 1 0 0 0 2 3 0 2 2
2132212203323212111100
1 1 2 3 2 0 0 1 3 1 1 3 1 2 1 3 1 0 2 1 2 2
0  0  1  1  1  3  2  0  2  2  1  3  3  3  0  1  0  0  0  0  0  0
1 1 1 0 2 2 3 0 3 3 0 3 0 1 0 1 0 2 0 3 0 2
1 3 2 1 2 1 1 2 2 1 2 3 1 3 2 0 1 0 2 0 3 2
3  1  3  1  0  0  0  2  0  0  3  1  3  2  0  0  2  0  3  3  0  2
1 1 0 3 3 2 0 3 2 2 2 0 3 1 2 0 0 3 1 3 2 2
3  3  3  1  1  0  0  3  3  0  1  1  3  2  1  3  2  3  2  0  2  2
0 3 1 3 3 3 3 2 0 2 2 2 3 3 0 3 3 0 1 0 1 2
3120213132101303323330
2  2  0  1  3  3  1  1  1  0  2  0  1  2  0  3  0  3  0  3  3  0
2 2 2 2 1 0 3 2 0 3 3 1 0 1 0 1 0 0 2 2 2 0
3 3 3 3 3 2 3 2 0 2 1 0 1 2 3 0 0 3 0 0 3 0
1 0 2 1 0 2 1 1 2 2 3 3 3 3 1 0 1 3 1 2 0 0
2 0 2 1 3 1 1 1 1 1 2 0 3 3 2 2 3 2 0 1 0 0
1  2  1  2  2  2  2  1  1  0  2  2  2  2  2  2  1  0  0  2  1  2
2122313213031301212022
2112200300231023011000
0  2  1  2  3  3  0  3  0  2  1  3  3  0  1  0  1  1  1  2  0  0
3  3  0  2  0  0  3  0  2  1  2  0  1  3  2  1  0  2  3  1  3  0
0023102000230331231010
2202221002032110220100
2233001102320111221210
1 3 0 3 1 1 1 0 0 1 3 0 2 3 0 3 3 3 1 0 2 0
0 3 0 1 0 3 2 0 1 3 2 3 2 2 1 1 1 3 0 3 1 0
3 1 0 0 0 0 0 0 1 3 2 1 2 1 2 1 3 3 2 1 1 0
2231031132200333310120
2  3  0  1  3  0  1  2  0  2  2  3  2  2  1  2  3  1  3  2  2  2
0011001110011000110000
