2 0 0 0 2 0 2 2 2 0 3 1 3 3 2 2 2 2 3 2 1 2 3 3 2 2 2 0 0 3 0
1032213203122213021220030131320
2 1 0 3 0 0 0 2 1 0 2 3 1 1 0 2 0 0 3 3 0 2 1 2 2 1 1 1 1 3 0
2  0  3  0  3  2  2  2  2  1  0  2  0  3  1  2  0  2  1  0  3  0  1  2  0  2  0  0  2  2  0
1  1  1  0  3  3  2  3  1  0  2  1  0  0  1  1  1  1  0  0  1  3  2  0  2  2  1  2  1  1  2
0  0  3  3  1  1  2  1  2  2  0  3  3  1  2  2  0  1  1  0  0  3  2  2  3  1  1  2  0  0  0
1 3 2 1 1 1 0 3 0 2 3 3 3 3 1 2 1 0 1 0 2 3 1 0 0 3 1 0 1 2 0
3 0 3 2 1 3 3 3 0 0 2 1 1 2 0 1 2 1 3 1 1 0 2 2 0 0 0 1 3 0 2
0 1 1 2 3 1 3 1 2 3 2 2 3 3 2 2 3 1 0 2 0 1 2 3 1 0 1 1 3 2 2
1303022121210311231120010001332
2331200201132103212131013220200
0  2  0  2  1  3  1  3  2  0  1  2  1  0  1  3  1  3  1  1  2  3  1  0  2  0  3  0  0  3  0
3023100031012222031332302331112
1311100203210002302120002232120
3  3  3  3  1  1  3  0  1  3  3  1  3  2  0  1  2  3  3  2  3  3  1  1  0  0  0  0  2  1  0
0333231323230021112033033100002
0311121022312320011233333110310
0130202211332301121211303203122
3121200233211210133311211112130
1 2 1 2 1 0 2 1 0 3 1 2 3 3 2 2 1 1 3 3 3 0 3 3 1 3 3 0 1 2 0
1 1 0 3 1 3 2 3 3 1 1 2 0 2 3 0 0 1 3 3 2 1 3 1 1 1 3 1 2 2 0
3  1  3  0  2  2  1  2  3  0  0  1  2  0  1  0  3  1  3  2  3  3  3  2  0  3  2  3  0  3  2
1322313231330121232010111120132
1  0  1  2  0  3  1  0  2  1  2  2  2  0  2  3  0  0  0  2  0  2  0  1  3  3  0  2  1  2  0
3 3 3 0 1 3 0 0 3 2 2 0 0 3 2 1 1 3 3 0 0 0 2 1 0 1 1 0 3 3 2
1  0  0  0  1  1  0  1  1  0  1  1  1  0  1  1  1  0  0  1  1  1  1  0  0  0  0  0  1  0  0
