1 2 3 1 2 0 3 2 3 0 0 2 3 2 2 1 0 0 2 0 2 1 3 0 0 1 2
1  2  0  2  1  1  1  1  3  2  3  0  1  1  2  2  3  1  0  3  2  3  3  0  1  3  2
0 2 1 0 0 0 0 3 3 0 0 3 0 0 0 3 2 1 2 3 1 1 3 2 0 0 2
2  2  0  1  1  2  1  0  0  3  2  2  3  2  2  1  1  0  2  0  2  3  3  1  0  2  0
213032220213002312222121020
112103020302132222223212120
031233103333110113213221332
0  3  2  2  1  0  0  2  3  1  0  1  0  2  0  0  3  0  1  2  1  0  1  3  2  3  0
332130002220110110200233222
121130011022012200031322230
200311232000321310300223302
0  0  1  0  0  0  1  0  0  0  0  1  0  0  0  1  0  1  1  1  0  0  1  0  1  1  0
