2  2  0  3  0  1  0  2
31210220
1 1 1 0 2 3 2 0
3 0 0 3 3 2 3 0
02333222
2  0  1  0  0  2  2  2
3 2 1 2 2 3 3 0
3 1 2 3 2 0 0 2
0 1 2 3 2 2 0 2
0  2  2  0  1  2  0  0
2  1  3  0  1  3  0  0
0  2  0  1  3  1  2  0
21223132
1 0 1 3 3 0 1 0
2  0  1  0  0  3  3  2
1 1 3 3 3 1 2 2
3  3  3  1  0  2  3  2
2  0  1  1  1  3  3  0
2 2 2 0 2 2 3 0
3  3  0  3  1  1  1  0
1 2 1 1 3 0 1 2
0 3 1 2 0 0 3 0
3  2  0  1  2  0  3  0
22332102
1  3  3  0  1  0  2  2
13001202
1 0 2 1 2 0 2 0
0  2  3  1  2  3  3  2
20000010
1  1  0  1  1  1  0  0
