1 0 0 3 1 0 0 2 0 0 3 1 0 2 2 1 3 0 0 2 3 3 0 0 0 3 0
2  3  3  1  1  3  1  0  0  3  3  3  1  2  1  0  1  2  2  2  2  3  0  1  0  2  0
0  2  2  1  3  1  0  2  1  2  1  2  2  1  2  0  0  1  3  0  3  3  2  2  3  0  2
122001213202010300333100022
131322100031213122211302200
021133002001122110332002010
021213330103320011332333112
0  1  0  2  2  0  2  3  0  2  0  1  0  0  3  3  0  2  0  2  0  2  3  3  1  0  0
1  1  3  0  0  3  2  0  2  1  1  3  1  3  0  2  1  2  1  0  0  2  1  0  3  0  0
2  3  3  1  1  0  0  1  0  1  0  2  2  1  1  3  0  1  2  0  2  2  1  0  1  3  0
0 1 2 2 1 1 3 2 0 2 1 1 2 1 1 2 0 2 3 2 2 0 2 3 0 3 0
2  1  2  3  1  0  3  2  3  3  1  2  3  2  2  3  1  1  1  1  1  1  0  2  3  1  0
3  1  0  2  0  2  0  0  1  3  1  3  2  0  2  3  2  3  3  1  1  2  2  1  2  3  0
2  3  1  1  0  0  2  2  0  0  0  3  1  0  2  3  3  3  1  1  1  0  3  0  0  3  2
3 2 1 1 3 1 0 0 2 1 1 2 1 0 2 1 2 3 2 2 0 0 2 0 3 0 0
0 1 0 0 3 3 2 3 2 2 2 0 2 1 2 0 1 2 0 1 0 2 3 1 0 2 2
1 1 3 3 0 2 2 1 2 3 3 2 0 2 1 1 0 0 3 2 2 3 3 2 2 2 0
221311302321303013221123022
0 0 0 1 1 0 1 0 0 0 1 0 0 0 0 0 0 0 1 0 1 0 1 1 0 1 0
