1 2 0 3 2 2 2 0
13131100
2  1  2  2  0  1  2  0
20102200
1  1  0  1  3  1  2  2
2  3  3  2  1  1  0  2
2 1 1 1 1 0 1 2
13010012
2  3  1  2  1  0  2  0
3  3  1  1  1  3  0  0
13120222
1  2  0  3  0  3  1  0
1  2  1  0  3  3  1  2
00302202
1 1 3 3 3 0 3 0
2 0 0 3 2 2 2 0
31303232
0  1  3  2  0  2  1  0
30123322
2  0  0  1  0  3  0  0
3  1  0  1  0  0  0  2
1  0  3  3  1  2  2  2
0 3 0 3 0 2 2 0
2  1  1  2  0  2  3  2
3 3 0 3 2 1 3 2
1 0 0 2 3 3 0 0
33210200
2  3  2  0  1  3  2  2
2 0 2 2 1 0 0 2
0 1 0 1 0 0 0 0
