2  1  0  0  1  1  0  2  3  1  1  3  3  3  1  3  2  0  0  2  1  1  2  0  3  1  0  1  1  0  0  2
0 2 0 1 1 1 1 2 3 2 1 1 1 0 2 2 3 1 1 2 1 2 1 3 1 1 3 0 1 2 3 2
12300212103121323313112020331010
13302121310113330223131221012312
23200323330333300320132111101220
2  3  1  0  1  0  3  0  1  0  0  0  2  3  1  0  3  0  2  3  0  1  1  1  3  1  0  3  1  3  0  0
1  0  1  3  3  3  2  0  3  0  0  1  2  1  3  1  1  2  0  0  0  2  3  0  3  2  3  1  2  3  3  0
0 0 0 1 0 1 0 0 0 1 1 2 0 3 3 2 0 2 1 1 1 2 1 0 2 1 2 0 2 0 3 0
1 3 1 3 0 3 0 1 1 0 0 1 2 0 2 1 3 3 2 0 1 3 1 1 2 1 0 1 1 1 2 2
1  3  0  2  0  1  2  2  0  0  1  3  3  2  0  3  0  3  2  1  2  2  1  0  1  3  3  2  3  0  2  0
1 1 2 1 3 1 2 3 0 0 0 1 2 3 2 2 1 3 0 2 0 2 2 1 0 2 2 1 2 2 1 2
0 1 2 2 1 2 2 0 1 3 0 1 3 0 1 3 0 3 2 2 1 1 3 1 0 2 0 2 3 1 2 0
1 2 1 1 2 1 3 0 1 0 3 0 3 0 3 2 2 0 2 1 2 1 3 2 2 0 3 2 1 0 3 0
0 1 0 1 3 2 3 0 0 1 1 0 0 0 2 2 2 0 2 3 0 3 1 1 3 3 3 1 0 0 0 0
30323322332203320123313200303230
0 3 3 1 3 0 1 1 3 3 3 0 1 3 1 3 2 1 1 3 2 0 0 0 3 0 2 0 0 0 2 2
2  1  1  0  3  2  3  0  0  0  1  3  3  2  0  2  2  0  0  0  0  2  2  0  0  0  0  1  0  2  0  2
10323223303011310113033211013212
3 1 2 1 0 2 3 1 0 2 3 0 0 1 0 2 0 0 2 2 3 2 2 2 2 0 0 1 0 0 2 0
2 2 3 1 0 1 2 2 0 2 1 0 2 3 2 0 2 3 0 2 2 3 1 0 2 0 1 3 0 2 0 2
3  2  3  3  1  1  1  1  2  1  2  3  0  3  0  1  1  1  2  0  3  0  1  2  2  2  1  3  3  3  1  0
00001010011011111000010111110110
