323133203032202003330100102
3  3  2  0  2  2  2  1  1  0  3  3  0  3  3  2  1  1  0  0  1  2  1  1  1  2  0
1 0 2 0 1 3 0 3 1 1 1 3 1 1 0 1 0 0 2 2 2 0 3 3 3 3 0
232130330200100030000133330
2 3 2 0 0 3 1 2 1 0 1 0 3 3 1 3 2 0 2 1 0 0 1 1 2 0 0
1 1 0 0 3 0 0 0 3 1 0 3 2 3 2 3 3 3 1 3 3 2 2 2 3 0 0
2 0 0 0 1 2 1 1 1 1 0 0 1 0 0 0 2 2 0 1 0 0 0 1 0 1 0
132202013112012110002100002
2 3 1 0 3 0 0 2 1 3 1 3 0 1 1 0 3 3 1 1 2 0 0 3 3 2 0
2 3 2 2 3 1 3 0 2 2 1 2 1 1 0 3 2 2 1 1 1 2 2 0 2 1 2
3  1  0  1  3  3  0  0  2  0  3  3  3  0  3  3  1  1  3  0  2  3  0  0  3  0  2
203312133032123111312022312
130333100223301200312102330
2  0  1  3  1  3  1  2  2  2  0  2  0  1  0  2  3  0  2  3  2  0  2  1  0  2  2
1  2  2  2  1  0  3  2  3  1  2  2  2  3  3  1  0  3  3  1  1  2  2  2  0  1  0
0  3  0  3  1  2  1  1  1  0  2  3  2  2  3  2  0  1  2  1  1  2  1  3  2  0  0
1 2 1 1 1 2 0 1 1 3 2 2 2 1 1 2 0 1 3 0 0 2 1 1 3 1 2
0  0  0  1  3  3  0  3  0  0  3  1  3  3  2  1  1  0  3  3  1  1  0  0  2  1  0
3  0  1  0  0  3  2  0  2  0  1  0  1  2  2  0  1  0  1  3  3  3  0  3  3  1  0
121120301130332303211333000
1  0  1  0  1  0  2  0  3  0  3  0  2  1  1  3  1  0  2  2  2  2  1  3  0  2  0
3 0 2 1 3 1 1 2 2 1 3 2 3 0 3 1 2 3 3 2 0 3 0 1 0 1 2
0  0  1  3  3  3  1  0  2  3  1  1  0  3  3  0  0  0  3  3  0  1  2  3  0  1  0
2 1 3 2 3 3 0 1 0 3 1 3 0 1 3 3 3 3 1 1 3 1 0 0 2 0 2
2  2  2  1  0  1  3  2  3  3  0  1  1  1  3  3  2  3  2  2  1  3  2  1  1  3  0
003312130312203112133221030
0 1 0 0 0 0 1 1 1 0 1 1 0 1 1 1 1 1 0 0 1 0 1 1 1 1 0
