3000311011320333322200300022332
1 1 2 2 1 2 3 3 2 2 3 0 1 3 0 3 2 3 0 3 0 2 2 3 2 1 1 3 2 3 0
0 3 3 0 2 3 0 3 2 2 1 2 3 2 1 3 0 2 1 3 1 3 2 3 3 3 3 2 1 0 0
1332231303020120023031231310010
3  1  3  0  3  0  0  1  3  1  0  1  2  0  3  1  1  2  2  0  2  3  1  1  2  1  3  1  3  1  0
0313022231300312033123333221110
0 2 1 2 0 3 0 0 3 1 2 1 1 3 1 3 1 2 3 0 1 1 2 1 3 0 2 3 3 1 0
1003230103030102201100301310302
3 2 1 1 1 0 1 0 0 3 2 0 0 1 1 2 2 3 0 3 1 1 3 2 0 3 3 2 0 1 2
3  2  0  2  1  0  0  3  3  3  1  2  3  0  0  2  0  3  3  2  3  3  2  1  2  1  2  1  0  2  0
2223230313101123330101011003212
0 0 3 2 2 0 0 0 2 1 2 1 1 1 0 3 3 2 1 1 1 2 0 0 0 1 1 2 0 3 2
1  3  3  3  0  1  1  2  2  0  1  2  2  3  1  0  1  3  2  0  2  1  1  3  3  3  1  0  3  1  0
0 3 3 0 2 1 1 2 0 2 2 0 0 3 0 2 2 1 2 2 1 0 3 0 0 0 0 3 1 0 0
0233310021111210133112130201110
1  1  3  0  3  2  0  2  0  3  3  3  3  1  3  0  0  0  1  0  0  3  2  2  3  0  3  1  2  0  2
1303213220023230013312110303302
3  3  3  2  1  2  2  3  2  2  0  1  0  1  0  1  2  2  0  1  1  1  2  2  0  1  3  3  0  1  2
1 0 1 3 3 3 0 2 1 1 2 0 0 3 3 3 3 2 1 0 3 3 0 1 2 2 3 0 3 0 2
1101011121001011322120330130320
3132001223032210213211301212330
1  0  1  0  1  1  0  1  0  1  0  0  1  0  1  1  0  1  1  1  1  1  0  1  1  1  1  0  0  0  0
