1 1 3 0 2 1 2 1 0 2 3 2 1 0 1 2 2 2
3  1  1  2  3  1  0  1  2  3  2  2  0  0  0  2  2  0
2  1  3  3  1  0  3  0  2  2  1  0  1  0  2  3  2  0
3 0 1 2 2 2 0 0 2 2 2 2 2 1 2 2 0 2
1  2  2  2  3  2  2  3  3  0  2  3  2  2  2  1  3  2
3 3 3 2 3 2 1 3 0 2 1 0 1 3 0 1 2 2
011131310031332130
3  1  3  1  3  2  2  1  0  2  0  3  0  0  3  1  2  0
322110023200022330
131320303220030110
221320103212102102
302312110121332010
101310102100331010
1  1  0  3  2  1  3  2  1  0  3  1  0  0  0  1  2  2
3 0 0 1 2 2 3 0 1 3 0 0 1 3 2 0 0 0
2  3  3  2  2  3  0  3  3  1  2  3  2  2  1  2  2  0
2  1  3  3  3  1  1  2  3  2  3  1  3  2  1  2  1  0
0  2  2  2  2  3  1  1  3  2  2  0  1  3  1  0  3  0
1 1 1 1 1 3 3 2 3 1 3 0 2 2 2 3 3 0
2  0  2  3  3  1  1  0  2  1  0  0  2  1  1  2  2  2
331011201110033320
3  0  1  3  2  0  1  1  2  3  0  0  1  2  1  3  1  0
1  3  0  3  1  2  1  3  0  1  0  2  2  2  0  3  1  0
0 3 3 0 2 2 3 3 0 3 1 3 0 2 3 1 1 0
0  2  0  1  2  1  1  1  3  0  2  2  0  3  3  3  2  2
2  3  1  2  2  2  2  0  1  2  3  2  3  3  3  2  3  2
1  1  0  0  1  1  0  1  0  0  0  1  0  1  1  1  1  0
