03213033012231013310230032021301131010
3 0 1 3 1 0 3 3 1 3 1 1 2 0 0 1 1 1 1 3 2 2 2 0 1 1 1 1 0 1 2 0 3 0 0 0 2 2
1 2 0 0 3 2 3 2 0 3 0 3 2 0 1 3 3 1 1 3 1 3 0 2 0 0 1 3 1 2 1 2 1 2 3 2 3 2
20133101023122022322103021321130220030
1  0  1  3  1  0  0  3  3  1  2  0  3  3  0  3  1  3  1  2  3  3  1  3  2  1  2  3  3  0  3  2  3  3  3  2  3  0
1 1 1 2 3 3 2 0 3 3 3 0 3 2 0 0 0 3 3 0 1 3 1 1 3 2 2 3 3 2 2 0 1 3 2 3 2 0
3  0  1  2  3  2  1  1  2  3  0  0  0  0  2  1  0  2  2  2  0  2  3  3  0  0  0  1  0  2  3  3  1  3  0  3  3  2
2  0  2  0  0  2  1  0  0  1  3  0  3  3  1  2  1  3  2  2  0  0  2  3  0  0  1  0  3  2  0  1  1  3  1  3  3  0
3  3  2  0  3  3  0  0  0  3  1  1  3  0  1  0  1  3  1  0  3  1  1  0  0  0  3  0  0  2  0  3  0  0  3  0  3  0
3 3 3 2 3 0 2 3 0 0 3 3 2 2 2 1 0 0 1 3 2 3 2 1 3 2 2 2 2 0 0 0 2 2 3 1 1 2
1  0  1  1  3  0  1  2  2  3  0  1  1  0  0  1  1  0  0  0  1  1  1  3  0  3  3  3  0  3  3  0  2  1  2  3  0  0
3  0  2  2  1  3  1  0  0  0  2  0  1  1  3  2  3  2  2  0  2  1  3  0  2  0  2  3  2  0  0  3  1  3  1  1  3  0
0 0 3 3 1 3 3 3 1 1 1 2 0 3 3 3 1 2 2 3 3 3 1 0 1 1 1 3 1 3 2 3 0 0 3 3 3 2
32033333030310013321033031203000330000
0  0  3  3  3  1  1  0  2  3  1  0  3  3  2  0  0  2  1  1  1  2  1  1  0  1  3  1  1  3  2  3  2  2  3  1  3  2
3  2  1  2  1  3  1  3  0  0  0  2  2  2  1  3  2  0  1  3  2  0  1  1  1  3  3  2  1  2  1  1  1  1  2  0  2  2
1 1 0 2 0 0 1 1 1 2 1 0 0 2 2 1 1 1 2 2 2 1 2 1 3 2 3 3 1 1 2 3 1 2 2 0 3 2
0 1 1 0 0 2 3 2 1 1 3 3 1 1 1 2 2 1 1 0 3 0 3 2 2 1 1 3 2 3 3 3 2 3 0 1 1 2
30021032030221320021000001000223010210
33103002333211022122232311013131010322
0 0 1 0 0 1 1 1 0 0 1 1 0 0 0 1 0 0 1 0 1 1 1 0 1 1 1 1 1 0 1 1 1 1 0 0 1 0
