132113113000311032320002000121210210320
3 1 2 3 3 0 3 2 1 1 2 1 2 1 0 2 0 2 2 1 2 1 1 1 2 2 1 2 2 3 0 0 3 1 0 1 3 2 2
133212133120301032011030312200331112122
323313000200020301012001332032132100330
3 3 2 0 3 3 2 1 0 1 2 3 1 3 3 1 2 0 2 1 3 3 0 3 2 1 2 0 0 3 2 0 2 0 0 0 3 3 0
212323333333020230310232011021131223010
1 0 1 3 3 1 3 2 2 1 1 0 1 3 0 3 3 1 0 3 2 2 0 0 0 0 1 2 0 1 2 3 2 0 2 3 3 0 0
0  0  1  3  3  1  0  2  3  2  2  2  3  3  3  2  1  0  1  1  3  1  2  3  2  2  0  1  2  0  3  0  0  2  3  3  2  1  0
123121320332220113223322333020032330000
0  0  2  3  2  1  3  1  1  2  2  3  0  1  2  3  3  0  2  1  0  2  3  0  3  3  3  1  0  0  3  3  2  1  2  3  1  3  2
320002300030030231120232210102103120302
0  1  0  3  1  0  0  3  0  3  1  3  3  2  0  2  2  1  0  2  1  2  3  3  2  3  0  2  0  2  0  2  2  0  3  1  2  3  0
2 2 0 3 0 0 3 3 1 1 0 3 0 3 0 0 3 0 1 1 0 3 1 1 0 3 1 0 3 1 3 3 3 2 2 1 1 0 2
1 2 2 0 1 2 1 2 2 2 2 0 2 1 3 0 1 2 3 0 2 2 1 0 0 3 2 1 2 2 0 3 1 2 3 1 2 0 2
112333113322223111110122030112131303120
303103002112331011110122011132213110012
3  0  2  3  0  3  0  1  0  1  2  0  2  0  0  0  2  0  2  0  2  2  3  1  1  3  1  0  2  2  3  0  0  2  2  3  2  1  0
0  0  1  1  1  0  0  0  0  1  0  1  0  0  0  1  0  0  1  0  1  1  1  1  0  0  0  1  0  1  0  1  0  1  1  0  0  0  0
