1  1  1  2  2  0  3  1  0  3  1  3  0  0  0  1  3  1  1  2  1  0  2  1  1  1  0  3  1  3  3  1  3  2  2  0
2  0  3  2  1  0  0  0  1  0  1  2  3  1  1  0  1  2  0  0  0  0  3  0  2  0  1  1  3  1  3  3  3  0  0  2
2 1 3 0 0 2 1 3 0 0 3 2 0 2 2 3 0 3 3 3 2 1 0 3 0 1 2 1 3 0 2 2 3 0 0 0
2  0  2  1  3  2  1  2  2  2  2  2  3  1  1  2  0  0  3  2  3  0  1  2  0  0  0  1  2  3  0  0  2  0  0  2
1  0  0  1  1  0  1  1  1  1  3  0  1  1  2  3  0  2  0  0  0  1  0  1  3  2  0  1  1  0  3  1  1  0  2  0
3 0 3 3 2 3 3 3 0 3 1 2 2 0 0 3 0 2 3 3 3 2 0 3 0 1 2 2 1 1 0 1 3 3 1 0
0 0 3 0 1 2 2 2 2 1 2 2 1 3 0 0 0 0 3 3 3 2 1 2 3 2 2 0 1 0 1 2 0 1 1 0
321111202030313011022310121000211322
303123320000302112210102303110331310
1 2 0 2 2 0 1 0 2 1 3 2 0 0 3 0 0 3 3 3 0 2 3 1 0 3 2 2 0 3 0 0 1 2 0 2
3  0  3  2  1  0  3  2  2  1  1  2  3  3  2  1  0  0  0  1  1  0  1  0  2  3  3  2  3  2  1  0  2  2  3  0
2  3  1  2  1  0  2  3  0  3  2  0  2  1  0  0  0  1  2  2  3  1  3  0  2  0  3  1  3  1  3  1  0  1  0  0
2  3  1  3  1  3  3  3  3  2  3  3  2  0  1  2  1  0  2  2  0  2  0  0  3  0  0  1  2  2  2  3  1  0  2  0
0  2  0  3  0  2  0  0  0  1  1  1  1  1  1  2  0  0  3  2  3  2  2  1  2  2  3  3  2  2  1  1  1  0  1  2
013321123300112330122032031313012002
031033103101232220131123010130203010
121330111100003323023100323022222120
0  3  1  3  2  0  1  3  0  1  1  0  0  0  1  3  3  0  2  2  1  1  2  1  1  1  0  0  1  1  0  3  2  3  2  2
2 0 0 2 2 0 0 0 2 2 2 3 0 2 0 1 0 1 3 1 2 1 0 1 1 2 0 1 0 1 3 0 3 0 0 0
0 0 1 1 0 1 0 1 1 0 0 1 0 1 0 0 0 0 0 0 1 1 0 0 0 1 0 1 1 1 1 1 1 1 1 0
