1  1  2  0  1  2  3  3  2  2  3  0  3  0  1  1  2
33011230032231130
12300233133321322
0 1 3 1 1 0 3 1 0 3 0 3 0 2 0 1 2
3 3 3 1 0 2 3 0 1 3 0 3 0 3 2 2 0
03300332212301220
01001131010031202
30301133223200030
23003112100020332
2 0 1 0 3 0 2 3 2 3 0 2 2 3 3 1 0
31020213013133200
2  1  3  0  3  2  0  3  3  0  0  3  0  2  3  2  2
0 3 3 2 2 1 1 0 1 0 1 2 3 2 1 0 0
3 2 2 0 0 0 3 3 0 2 2 2 2 0 3 0 2
3 0 2 3 2 1 1 1 1 2 1 3 3 1 2 0 0
30123100022130132
32000110130321010
0  2  0  1  3  3  0  3  2  0  0  1  0  2  1  3  0
2  2  1  3  0  0  1  0  1  3  1  0  1  0  0  2  0
1 0 2 0 0 1 1 3 0 3 2 1 0 1 1 2 0
3  2  1  1  2  3  2  0  2  3  1  3  3  1  0  3  0
21022011011312300
2  0  2  3  3  2  2  0  0  2  0  0  1  1  2  1  0
2  2  0  0  3  0  2  3  0  2  2  1  3  0  3  2  0
03212322222300130
3 0 3 3 1 0 3 3 3 0 3 0 1 1 3 2 2
00122301323101112
3 2 3 3 3 2 0 0 2 0 2 3 3 3 2 1 0
01121231300030330
01101011011110110
