2231112122003010322
0  2  3  2  0  3  0  0  1  3  0  3  3  3  2  0  0  0  0
1100033322311102012
3102311022121020322
3 3 2 2 1 2 1 3 3 3 1 3 2 3 3 2 1 0 0
1  2  3  2  1  1  2  2  0  1  2  0  3  3  0  3  1  3  2
2 3 0 3 0 0 0 2 2 3 2 0 1 3 1 2 1 3 2
3011220220303212032
0100313332010131330
2132013211113230000
1212223221302132112
1 3 2 2 0 0 1 1 0 3 0 0 0 3 0 0 1 1 2
3112233311023223320
1111000110110000000
