2  2  2  0  1  2  0  1  3  2  2  1  3  3  1  3  2  3  1  0  2  0  0  0  2  0  1  3  3  0  1  3  1  0
1  3  3  1  3  0  3  1  2  3  2  0  2  1  0  0  2  0  3  0  2  3  2  2  0  1  2  0  3  2  0  1  1  0
0  1  3  3  3  0  0  3  3  1  0  3  2  3  0  2  1  0  1  0  1  3  3  2  0  1  1  1  1  3  1  3  3  2
2301031222223112220331121102330210
3  1  3  0  2  2  3  0  1  3  1  2  0  1  1  0  3  3  1  2  3  3  2  1  3  2  1  0  3  1  0  2  1  0
2 2 1 3 1 0 1 1 0 2 0 1 1 1 0 2 2 0 2 1 2 1 2 0 1 0 3 1 3 1 0 2 1 2
1011102020313331031323000103101032
1 2 2 3 2 2 2 0 1 3 1 3 2 0 2 3 2 2 0 0 1 3 1 1 2 1 0 2 0 2 2 0 2 2
1  0  0  0  0  2  1  1  2  1  3  3  3  2  2  2  1  1  0  2  1  0  3  0  1  3  0  3  1  3  3  2  2  0
0 3 2 2 0 2 1 0 0 3 3 0 2 0 3 2 0 0 1 1 0 3 1 3 0 2 1 3 2 0 3 3 2 0
3000121133132323202031031320123200
2  2  1  1  3  0  2  2  2  1  3  1  1  2  1  3  1  2  2  0  3  3  3  1  1  2  0  1  1  1  2  0  2  2
1  0  2  3  2  1  2  0  3  2  0  0  1  1  1  2  0  3  3  0  2  2  2  0  1  0  3  3  2  3  3  0  3  0
0310200100030323020111031232012100
2  3  0  2  1  3  1  1  3  3  1  0  3  2  0  2  1  2  2  3  1  1  3  2  2  1  3  2  1  0  3  1  0  2
3  2  1  2  2  3  2  3  0  3  3  3  0  2  2  1  1  3  0  1  0  0  3  3  2  3  3  1  2  3  3  0  1  2
3 0 2 3 0 3 2 1 3 1 2 3 3 1 0 3 1 2 0 2 1 3 3 2 0 1 2 1 1 3 0 0 0 2
3212330132013332120013212123201210
2032232113001123321320232000333110
2 0 1 3 0 3 1 1 0 3 2 3 1 3 2 0 3 3 3 3 3 1 0 2 3 1 1 2 0 0 1 0 3 0
3  0  1  0  2  1  2  1  1  2  0  3  2  0  3  0  2  2  1  3  2  0  3  1  1  1  0  3  1  0  2  2  2  0
2 0 0 1 3 1 2 2 0 1 3 0 3 1 1 2 2 3 2 2 3 0 3 0 1 3 1 0 2 1 1 1 0 2
3 2 1 3 3 0 1 2 0 2 3 0 2 2 0 1 3 0 2 1 2 0 2 1 3 3 2 0 3 1 1 1 0 0
1200022001101300221230202230330100
1 1 0 0 0 0 1 0 0 1 1 1 1 1 1 0 1 1 1 0 1 1 0 0 0 0 1 1 0 1 0 0 0 0
