320102
1 0 1 2 3 0
3 2 3 0 1 2
213310
2 2 2 1 3 0
2 0 3 1 2 0
2 2 1 1 1 0
330300
1 3 0 1 2 0
1 1 1 1 0 0
