30031320001110303213102121333322
10013002211201233113113220303302
3 2 2 2 2 2 1 3 1 2 1 3 0 1 1 0 1 2 2 2 1 1 1 2 3 2 1 2 0 1 0 2
2  0  3  1  3  1  1  3  0  0  3  2  0  3  2  2  1  3  3  3  3  3  0  1  0  2  0  3  2  0  1  0
20123202020120010220002300021120
32200212110000032132001132122010
1 0 0 2 0 2 0 2 1 2 1 3 1 1 2 2 3 3 3 0 2 1 0 1 0 1 1 0 0 3 3 2
3 0 2 0 3 2 2 2 3 2 1 0 2 0 3 2 3 1 2 0 0 2 1 3 0 3 3 1 0 3 3 0
3  0  2  2  1  3  1  0  1  3  2  1  3  0  3  2  2  1  0  1  3  1  3  2  3  1  2  3  1  2  2  2
1 1 1 1 1 3 3 2 3 0 3 1 3 1 2 2 0 0 2 0 3 2 0 2 1 2 2 2 2 2 0 2
2  3  2  3  3  2  1  1  2  3  2  2  0  1  2  1  1  1  1  1  2  0  0  1  1  0  3  0  1  0  0  0
10212303303012213203300231310112
0  1  1  1  3  1  2  1  2  1  0  1  0  1  2  2  3  0  0  1  3  0  1  3  0  3  3  1  3  3  3  2
11003132303101211202122102120132
31120032200311220012302223232230
32100033030032300203110121310330
11112323131311100323323320230100
3  1  0  3  2  0  2  0  3  0  1  2  1  3  3  0  3  3  0  3  3  0  2  0  0  3  1  3  2  2  1  0
22031322102110323210310321030232
01310030311011032003311023200010
23132022101330101100332321310020
33311222202021101221232202200220
22212310002310022320202312030220
0 0 0 1 0 2 2 3 1 3 2 0 1 1 2 1 3 0 0 1 1 0 2 2 0 3 2 1 0 1 3 2
30213222032010010310033003201212
02302101331002323023130001310300
1  3  0  0  2  0  1  2  2  3  2  0  1  2  1  0  0  2  3  3  2  1  2  3  2  0  1  1  3  1  3  2
0 2 0 0 2 2 2 3 2 0 1 3 2 2 3 0 0 0 1 2 3 2 1 1 1 3 2 3 2 1 2 2
2  3  3  1  3  1  0  3  3  0  0  2  2  3  1  3  2  1  0  0  2  2  3  2  3  2  0  0  2  0  2  2
1  0  1  1  1  1  1  0  0  0  1  1  1  0  0  1  0  1  0  1  0  1  1  0  0  1  0  1  0  0  1  0
