0 2 3 0 3 2 3 3 1 0
3 2 3 3 3 2 1 1 3 2
1203001320
3  3  3  1  0  1  1  1  2  2
2013302002
0201122012
3  0  2  2  2  1  1  0  2  0
1  0  0  0  0  1  1  1  0  0
