3323330021012212020130203110
2  3  3  0  1  0  3  1  0  3  1  1  3  3  1  2  0  1  1  2  2  2  2  1  1  2  2  0
1  1  0  1  1  3  2  2  2  1  0  2  2  1  0  1  3  3  3  2  1  3  3  2  2  1  1  0
2030222201033130020011212230
0  3  3  1  1  0  2  2  1  2  2  2  0  1  3  0  0  0  1  0  3  0  3  3  1  1  3  2
0  0  0  1  2  2  1  2  3  3  3  2  1  2  1  1  2  3  1  3  1  0  1  2  1  1  0  0
2201311033103320333011100232
0112021301300020021232132112
0 0 3 0 0 2 1 1 1 2 3 2 2 3 3 1 3 0 0 2 3 3 2 3 0 1 2 2
0 0 1 2 1 3 2 1 3 3 1 0 1 3 1 3 0 3 3 2 3 0 1 1 2 0 1 2
2  1  2  3  1  3  3  3  3  2  2  1  3  0  0  2  2  2  2  3  0  2  1  2  2  1  3  0
1100101100101101110010011010
