2  1  1  0  2  0  1  2  3  3  3  0  1  3  3  2  2  0  1  1  2  2  1  2
310232120120333211002100
2 2 2 0 2 0 0 0 2 0 2 2 0 3 2 2 0 2 0 1 1 3 1 2
2 1 3 2 3 3 0 0 2 3 2 1 1 1 0 2 3 0 2 0 2 1 1 0
010203000313103120320132
110032122031223010020010
322120222113303003303212
0 2 1 3 2 1 2 2 0 0 0 3 1 0 1 0 2 0 1 1 3 1 3 0
3  2  0  1  1  0  1  2  0  0  0  2  1  2  3  3  3  0  3  3  1  1  1  0
3  1  2  2  2  3  3  1  3  3  0  2  3  1  0  1  0  2  3  0  2  1  0  2
3 1 2 3 0 1 0 0 3 0 2 0 2 2 2 2 0 1 3 3 0 1 3 2
1  3  2  1  1  0  2  3  2  0  0  1  3  2  0  0  1  3  3  1  0  2  0  2
321232110232333013101210
0  1  1  2  0  1  0  1  1  3  3  2  0  3  0  0  2  0  0  1  0  2  1  2
0  3  1  1  3  1  1  1  2  1  0  2  1  3  1  3  1  3  2  3  3  3  1  2
321230031230013003103110
2  0  2  0  2  3  2  0  1  3  1  2  1  2  3  3  0  3  0  1  2  3  1  0
2  2  1  2  0  0  0  2  0  2  2  0  0  0  1  1  2  2  3  0  2  1  0  2
122323303322000233230022
3 3 3 2 1 0 0 0 1 2 2 2 2 1 0 2 0 1 1 1 3 1 0 0
1  2  0  2  0  3  2  0  3  3  2  0  2  3  2  2  1  2  1  3  1  0  1  2
2 0 1 0 2 0 2 3 0 2 2 3 0 0 1 2 1 1 0 1 2 2 2 0
3  1  2  1  2  1  0  0  0  3  3  2  0  3  3  0  0  3  2  3  1  2  2  2
001021123012111022120000
0 2 1 1 3 0 1 2 3 0 2 1 1 1 2 2 1 1 0 1 1 2 2 2
332022022133020111313210
2  1  2  2  0  3  1  3  3  2  2  1  1  2  3  2  3  0  2  2  1  0  2  2
2 0 3 2 0 3 2 1 3 1 1 2 3 3 3 2 2 3 2 1 1 3 1 2
1  3  0  1  1  2  3  3  0  1  3  3  3  2  1  0  2  1  0  3  1  1  2  2
322211011112211121302300
0 1 0 0 0 0 1 0 1 0 0 0 1 0 1 0 1 0 1 1 1 0 1 0
