0 3 1 0 3 1 0 3 2 3 0 3 1 1 0 3 1 3 2 0 2 3 0 3 0 0 3 2 0 3 2 0 1 0 0 1 2 3 0 2
0 2 2 3 1 0 3 0 0 1 2 1 0 2 2 3 2 3 1 1 3 0 1 1 2 3 2 3 0 0 0 1 2 0 3 0 0 2 3 0
0 0 0 0 1 2 2 1 3 1 1 3 2 1 3 0 0 0 2 1 0 3 1 1 2 2 3 3 3 3 2 3 3 0 0 1 3 1 0 2
2  3  2  0  2  0  0  2  3  3  0  0  0  0  2  0  3  2  3  2  3  2  2  0  1  1  3  2  0  3  0  3  0  1  0  3  3  2  2  2
1130132230301003003313320331232213033112
2  0  3  3  0  3  0  0  1  3  1  0  1  2  3  1  3  0  0  3  2  2  0  2  3  2  2  0  2  1  2  1  0  2  3  1  0  0  0  0
2  1  0  0  1  2  2  1  2  3  3  3  3  3  1  2  1  1  0  1  1  0  3  0  1  3  0  0  3  3  3  0  1  1  0  2  2  2  0  0
3113000300302331033223312310230212300122
2  1  1  3  0  1  1  3  0  2  3  0  2  2  2  0  2  3  2  0  0  1  1  1  2  2  0  2  1  2  0  0  3  3  0  3  0  2  0  0
1  2  0  3  0  1  0  2  0  0  2  1  3  1  2  3  3  0  2  1  0  3  3  1  2  0  1  1  3  3  2  2  1  2  1  3  2  3  0  0
0012112113101320302331222132210103103102
3  0  3  0  3  3  3  2  2  1  1  3  2  0  3  0  3  2  1  1  0  0  3  0  0  1  2  3  2  1  1  0  2  2  1  3  1  1  3  2
1  2  1  1  0  3  0  1  3  1  3  3  3  1  3  1  2  1  0  3  0  0  0  2  2  0  3  3  3  3  3  1  0  3  0  0  3  2  1  2
0222233112213322111220323202132311000230
3103200032033231113101120312001312002320
2  3  2  0  1  2  2  0  2  0  2  0  3  0  0  0  3  1  0  1  2  1  1  3  0  3  1  2  2  2  0  0  0  2  2  2  3  0  3  0
2 1 0 2 1 0 1 0 0 3 3 2 2 0 0 2 3 2 1 3 2 1 0 0 2 3 3 0 1 3 0 1 2 1 2 3 2 2 0 2
2221331220122132312333321121223000210232
0  3  2  0  0  1  2  0  2  0  1  0  0  2  1  3  0  2  0  2  3  3  1  0  1  3  3  3  2  2  3  1  1  2  0  0  0  1  0  2
2330222113003131320000213323010123303332
3  0  2  3  2  3  0  1  3  1  3  3  1  1  2  2  2  3  3  3  1  2  0  3  0  0  0  3  1  0  0  2  3  0  3  0  3  3  1  0
2  2  1  2  1  3  3  1  2  0  3  0  3  0  1  3  0  3  0  0  1  1  0  1  3  1  1  0  1  0  2  1  1  0  3  1  3  0  0  2
1  0  0  2  3  0  3  0  2  0  3  3  2  0  0  2  0  1  3  0  1  0  1  3  3  0  0  2  0  3  2  0  2  0  2  2  3  1  3  0
1  2  3  3  3  0  1  3  0  0  3  1  3  3  1  3  3  1  1  1  2  1  1  3  1  3  3  3  1  2  1  3  3  3  2  1  3  2  2  2
3 1 3 1 3 1 1 2 1 3 3 0 2 0 2 0 2 2 0 2 1 2 3 3 2 0 0 2 3 2 1 0 3 0 1 3 3 2 3 2
1 3 2 2 2 3 0 2 2 3 1 2 1 0 0 3 0 1 2 2 1 2 0 3 1 2 0 2 0 2 0 2 1 0 1 3 1 3 3 0
1 1 0 0 3 3 2 2 0 2 3 1 3 3 2 2 1 1 0 0 1 1 3 2 2 3 2 2 3 2 1 1 3 3 2 2 3 0 2 0
1103302220312331330213012310222133021220
0302133030331123012322023203023231211120
3  2  3  1  0  1  2  2  0  1  2  1  1  2  3  0  2  0  1  3  3  0  0  1  2  0  3  1  2  3  0  0  2  0  2  3  1  1  3  2
0110001110000110001100100100111111101000
