1001133003101113032132122000
3  2  0  3  2  2  0  3  1  3  1  2  3  1  1  3  2  1  0  1  3  0  3  3  3  3  0  2
3  2  3  2  2  2  0  0  1  1  3  0  2  0  1  3  3  1  2  0  3  3  0  2  3  0  1  0
0 3 1 0 3 0 2 1 1 3 3 3 1 3 2 1 3 2 0 1 2 1 3 2 2 1 1 2
2 3 1 0 1 0 3 0 3 1 2 0 2 1 2 3 3 2 1 3 0 1 0 3 0 1 1 0
0  1  0  2  3  2  0  2  1  3  0  2  3  1  2  1  1  1  3  3  0  0  3  3  3  1  2  2
3 0 3 3 2 1 2 1 3 0 2 1 0 3 0 1 2 2 0 2 1 0 1 2 3 2 1 2
2 3 0 1 2 1 1 3 2 2 3 2 3 2 1 1 1 0 3 2 0 3 0 1 0 0 1 2
0231020330213020112323312220
1 0 1 3 0 1 3 0 0 0 0 1 3 3 3 1 0 1 1 1 1 1 3 3 3 0 0 2
0 1 1 3 1 3 0 2 2 3 0 3 1 3 1 3 3 1 2 2 2 3 0 0 0 3 0 0
0 1 3 1 2 1 3 0 0 1 0 1 2 0 1 0 2 0 3 3 3 2 3 0 2 2 1 2
1311020212020012210302230102
3120220332301203111233122100
0 0 3 1 0 3 3 0 0 3 0 2 1 1 3 1 1 0 0 2 3 2 3 1 1 2 0 0
2312320100112002221132001310
3201230201032233033101210222
1 1 0 1 3 3 2 0 0 0 0 1 0 0 0 0 1 1 1 0 0 0 1 2 1 0 2 0
0 2 2 1 0 3 2 2 1 1 0 2 3 0 1 2 1 0 3 0 1 0 1 1 2 1 3 0
0 0 0 0 0 1 3 1 3 2 1 2 0 2 0 2 1 2 2 1 1 1 3 0 0 2 1 0
3  0  0  2  1  1  2  3  2  0  2  1  0  3  0  1  2  1  1  3  0  2  1  2  3  1  2  2
1 2 2 2 2 3 2 0 0 2 3 0 3 3 1 2 1 1 0 3 3 0 1 1 0 1 0 2
3012201102033000001212013010
1  1  1  0  0  1  1  0  0  0  1  1  1  1  1  1  0  0  1  0  1  0  0  0  0  1  0  0
