3  1  1  2  0  1  2  0  2  0  2  3  1  1  1  1  2  3  2  0  2  1  1  3  1  1  2
1  1  3  2  1  3  3  1  1  3  2  0  1  3  1  2  2  3  3  0  2  0  1  2  3  1  2
103321331013120313022312020
3 1 1 0 2 3 2 1 0 2 2 1 2 3 2 1 0 3 0 2 1 0 0 3 0 0 2
233010223302323300022202000
3 2 3 0 0 3 0 1 2 2 3 1 3 2 2 0 0 2 2 3 2 3 3 0 2 3 2
2 2 1 3 2 2 1 2 2 3 0 3 3 3 2 0 3 1 0 0 0 2 0 0 3 3 2
3  2  1  2  3  1  1  3  2  2  1  2  3  0  0  3  1  2  1  1  3  3  1  0  1  2  2
0  2  2  2  1  2  1  3  3  2  1  0  0  0  2  3  3  1  0  3  0  2  1  0  3  2  0
1  2  1  3  2  1  2  2  2  3  3  1  0  3  2  3  0  2  1  3  3  1  3  0  2  0  2
1 1 2 3 1 2 2 1 3 3 1 1 2 1 1 2 2 3 1 3 2 1 2 2 3 2 0
100131203210102011121013020
3 3 2 2 0 2 0 2 2 1 0 1 3 1 0 0 3 2 3 0 3 2 0 0 0 1 2
3 1 0 3 1 1 3 0 3 2 0 0 1 1 2 3 3 0 2 0 2 1 0 2 2 3 2
2 0 0 1 3 0 2 2 3 1 0 3 0 2 2 1 0 3 3 1 3 3 2 0 0 3 2
0 1 3 1 2 3 0 2 2 0 1 0 1 1 0 2 2 1 2 3 3 2 1 1 3 1 2
100111100011000111000101110
