0 3 1 1 3 3 2 3 2 3 3 2 3 2
21003212130310
0 0 3 1 0 1 2 1 2 3 1 2 2 0
1 3 3 2 1 1 1 1 1 0 2 2 2 0
0  3  0  1  3  0  1  0  2  1  3  3  3  0
12123303023322
1  0  1  1  0  0  1  0  2  3  3  3  0  0
3 2 0 0 0 1 1 0 1 1 2 1 1 2
0 2 0 3 1 3 2 3 1 3 0 1 2 2
10023103111212
0  1  2  0  3  1  3  1  3  3  2  0  3  2
0 0 3 2 3 2 1 1 1 1 2 1 3 2
3  2  0  1  1  0  2  0  2  3  2  0  3  2
0 3 2 0 1 2 0 3 2 1 1 3 2 2
2 3 0 1 3 2 1 0 0 2 3 1 3 0
22021032200230
21120231211330
0 0 0 1 2 3 1 0 2 3 0 1 1 2
3 0 0 1 3 1 3 2 3 3 0 1 3 0
30020212020232
1 0 0 1 1 1 1 0 1 1 0 1 1 0
