2  0  0  2  3  1  0  3  3  3  0  2  1  2  3  3  2  0  1  0  2  3  3  1  2  1  0  2  1  2  2  1  2
1  2  3  3  0  3  2  2  1  3  3  2  2  1  1  1  3  3  3  2  1  3  3  3  0  3  0  3  2  3  1  0  0
312103333301132223101232211121000
3  2  3  3  1  0  1  3  3  2  0  1  2  0  3  3  3  0  1  0  0  0  3  3  2  2  3  2  0  1  0  3  0
112011211311120020312333331231212
3  2  0  1  0  0  3  0  3  1  1  3  1  1  1  2  0  0  0  0  0  1  1  1  2  2  2  1  0  2  3  1  2
223112332013332300003210113201200
0  3  3  1  1  0  2  3  3  0  2  1  2  1  2  1  0  0  2  2  3  3  0  2  3  0  3  3  0  1  1  0  2
311213021032210333003112133100110
311112220213103323100121002332212
0 1 0 1 0 1 2 0 3 3 3 2 3 3 1 2 0 2 0 1 3 1 2 1 0 2 3 1 3 0 2 2 0
3  0  2  3  2  0  0  2  2  3  1  3  2  0  0  2  2  2  3  1  3  0  0  3  0  1  3  3  3  2  2  2  0
3  1  2  3  2  0  2  1  1  3  0  3  3  1  0  3  2  2  0  2  3  3  2  0  2  2  3  2  0  1  1  3  2
3 1 3 0 2 3 2 2 3 0 1 3 0 0 0 1 1 1 1 3 0 0 2 2 1 1 2 2 0 2 3 3 0
0  0  2  1  0  2  2  0  1  1  1  0  3  2  2  0  2  3  2  3  2  3  1  2  0  0  3  0  2  2  3  2  0
3 2 1 0 1 0 2 2 3 1 1 1 0 0 3 1 1 1 3 1 2 3 0 3 0 2 0 2 3 0 3 3 2
0 3 2 3 2 3 0 0 1 2 1 1 2 3 2 2 2 3 2 2 0 0 3 2 0 2 2 0 1 3 2 2 0
0 3 3 1 3 0 3 0 1 2 3 0 3 3 1 3 0 1 2 1 1 2 1 0 2 2 2 2 2 0 0 3 0
3  0  1  3  2  1  2  0  2  0  1  3  2  2  2  2  2  3  3  2  3  1  2  2  1  2  1  3  1  3  1  2  2
1 0 1 1 1 1 3 1 0 0 2 0 3 2 1 2 1 2 0 1 0 2 3 3 3 1 2 3 0 3 2 1 0
0 1 2 3 3 1 1 2 2 2 3 0 2 1 3 3 3 0 1 2 1 0 3 0 3 1 0 2 0 1 0 2 0
3  2  0  3  0  3  2  3  3  2  0  2  0  1  2  2  2  2  0  3  2  1  3  1  1  3  2  2  1  3  1  1  0
1 0 1 0 0 1 0 1 0 0 0 1 0 1 0 0 1 1 1 1 1 1 0 1 0 0 0 0 1 0 1 1 0
