2 2 3 3 1 2 2 1 1 3 0 3 3 3 2 3 0 3 1 2 2 1 0 3 3 1 3 0 0 0 3 1 0 0 0
10213103012003131200313132231100302
32211320021033011032231110133223312
2 0 1 0 0 2 0 1 0 2 1 2 1 1 0 1 0 1 0 0 3 3 0 0 2 0 0 0 1 2 2 1 3 0 0
1  0  0  2  1  2  3  3  3  1  0  3  2  1  0  1  0  2  0  2  2  2  3  1  2  3  2  3  0  0  2  2  1  3  0
10013030022103012102321211010313322
02030320230001232303012221310001312
3 0 2 1 2 2 0 0 1 3 1 2 3 3 0 2 2 3 3 1 3 1 1 0 2 3 0 3 1 3 2 3 2 1 0
12030113312012013003121301100003230
3  0  2  2  0  3  3  0  2  0  2  0  2  1  3  0  3  3  1  3  3  0  2  0  3  1  1  1  0  3  2  0  1  3  0
13221110110233021202103003130220032
2 2 2 0 2 2 2 0 1 1 2 1 3 2 2 1 3 3 0 2 1 2 2 1 0 3 0 3 2 2 0 3 1 1 2
0  0  0  1  3  0  2  3  3  1  1  3  1  1  2  2  2  0  0  1  2  2  3  1  2  2  2  3  3  3  3  2  1  3  2
22330133312020012320333210321221312
01110030310131113131213012103121032
23120332031013123312310131313121322
1  2  3  0  0  2  0  1  2  0  2  3  0  3  3  1  0  3  2  2  0  2  0  3  1  0  0  2  2  2  0  0  3  1  2
0  0  3  2  0  0  1  1  1  0  3  2  3  1  0  0  0  0  2  0  2  3  0  1  3  0  1  3  0  3  3  3  0  1  0
2 2 2 1 3 1 2 1 2 2 2 3 0 0 0 1 0 3 1 2 1 3 2 2 1 2 3 1 0 0 3 1 1 0 0
1 3 1 0 0 3 1 1 3 3 0 2 2 2 3 3 0 1 2 1 2 0 1 2 0 2 0 1 3 0 0 1 0 1 0
0 2 0 3 2 0 2 3 0 3 1 3 2 1 3 0 2 2 3 1 3 3 0 2 3 2 1 2 0 1 3 2 0 0 0
0  1  0  2  2  2  0  2  2  0  3  1  2  3  2  3  3  2  2  0  2  0  1  0  3  3  0  3  0  2  2  0  2  1  2
1 2 3 0 0 0 2 3 1 0 1 2 3 0 1 1 1 1 3 1 2 0 1 0 3 1 1 2 3 3 1 2 3 2 0
00110110111110010001010001011110000
