1  1  1  3  1  3  1  1  2  3  1  2  1  2  0  2  1  0  3  3  0  3  1  0  1  0  1  2
1331231030210022000113303010
1  1  1  3  0  1  0  1  0  2  1  1  1  2  0  2  1  1  1  0  0  0  3  1  3  0  1  2
2  2  1  2  3  1  1  1  3  2  2  1  2  1  2  0  1  0  1  1  0  0  3  0  2  1  2  0
3  3  3  0  0  3  1  2  3  2  1  3  2  0  0  1  3  2  0  0  3  3  2  0  3  1  3  2
0220200112032200332302312132
0220233031120013123122310002
1010321211232133313121130112
0202013000330021223303211200
0 3 0 2 1 0 0 2 1 0 0 1 1 2 0 3 1 3 0 1 1 1 1 0 3 1 1 0
3 1 3 0 2 3 2 0 1 3 2 2 3 2 0 2 2 2 2 3 0 1 2 0 1 3 1 2
3020222222120310312023020220
3  3  1  2  0  2  1  3  1  0  1  0  3  3  1  2  1  3  3  0  2  0  2  2  1  3  3  2
0  3  3  3  1  1  1  3  0  1  1  2  2  1  0  0  0  0  0  0  1  0  1  0  2  0  3  2
2002010322213323233013213120
1 3 3 3 3 3 0 1 0 1 0 0 2 0 2 1 2 1 1 1 2 0 1 1 3 1 3 0
3002302120331321313133230030
3330120022322111330330110320
3 1 0 0 2 3 3 2 3 1 1 1 0 2 3 0 0 3 2 1 2 1 3 3 1 2 0 2
3 0 1 2 2 0 0 2 3 2 3 2 3 3 3 1 1 1 3 1 3 3 1 3 1 0 0 2
1  2  1  3  3  1  0  1  1  0  0  2  1  0  0  0  1  1  1  3  2  1  2  1  0  3  3  0
3  2  3  2  2  3  1  2  0  2  1  2  0  0  3  0  2  3  1  3  3  0  2  2  2  1  2  2
1 1 3 3 0 2 3 2 0 0 2 0 1 2 0 1 3 2 0 0 3 0 1 0 2 0 2 0
1  2  1  3  0  0  1  2  3  2  1  0  0  3  2  1  1  1  2  2  1  0  2  3  0  3  1  0
3003300303202312113113321330
1  3  3  0  0  3  0  2  2  0  0  1  1  0  0  3  0  0  2  1  1  3  2  0  0  1  3  2
1111000101100111011010000110
