3333012
2001220
1232320
2020212
2  1  1  2  3  1  2
0  2  0  1  1  2  2
2320002
1  2  3  1  3  0  0
2  3  3  3  3  3  0
2 0 3 2 0 3 0
1  0  1  1  0  2  0
0  1  0  1  1  0  0
