0  2  1  1  1  0  2  0  3  0  1  2  0  3  0  1  3  1  0  3  2  2  3  2  3  1  0  2  0  3  1  0  2  0  3  2
1 3 3 2 3 2 0 0 3 0 0 3 2 3 1 3 3 1 2 2 2 2 2 2 0 3 3 3 3 1 3 0 3 1 2 0
1  1  2  3  2  2  1  0  2  2  1  0  0  1  1  3  2  3  2  3  2  3  1  2  3  1  2  0  2  3  2  3  2  1  1  2
1 1 2 0 2 2 3 1 3 1 1 0 2 2 1 2 2 3 1 1 2 3 2 2 0 3 2 1 0 0 0 1 0 3 1 0
113311212223112331231010032311323010
1 3 0 3 3 1 0 2 2 0 0 2 3 0 3 1 0 1 1 0 3 3 1 2 2 3 1 1 0 1 1 2 2 3 2 2
122130122200310210222101230300302312
022123200132032300132101030233130202
0  3  2  1  1  0  3  2  1  3  3  1  0  2  1  3  1  0  0  0  0  0  3  3  1  3  3  2  0  0  1  0  2  1  0  2
2  1  2  3  1  2  2  2  3  2  3  0  2  3  2  3  0  0  2  1  1  0  0  0  2  0  0  0  3  0  3  2  3  0  1  2
121330301103313333300221330001301112
231120111030331203220322312021212330
3  2  1  0  2  3  1  2  1  0  2  2  2  1  3  2  3  1  2  1  3  3  3  2  0  1  1  2  2  1  2  2  2  0  3  0
2 3 3 1 2 3 3 0 0 3 3 0 1 0 3 3 2 3 2 0 0 0 2 0 2 1 2 1 0 0 1 2 3 0 3 2
0  1  0  3  3  1  2  2  3  1  2  2  3  0  3  0  1  0  2  0  1  3  2  3  0  3  1  2  2  1  2  3  2  0  3  2
030212001003100202032313203120113122
0 2 2 3 2 0 1 1 1 0 2 0 3 2 2 0 3 2 3 0 2 2 0 1 1 2 0 3 3 3 0 2 1 1 0 0
312120321012032210021231230231213232
1 1 1 1 0 0 0 1 1 1 1 0 1 0 0 1 1 1 1 1 0 1 1 1 0 0 0 1 0 0 0 0 1 1 0 0
