1  1  1  0  1  3  1  2  1  3  2  1  3  1  2  0  1  3  3  3  1  3  2  1  2  3  1  1  0  1  0
2  1  2  3  3  1  2  2  2  2  3  3  0  2  3  2  0  3  1  0  1  0  2  0  3  3  2  0  3  2  2
3301100002032102323030133101110
0 3 1 2 2 2 3 0 3 3 0 1 2 2 2 3 2 2 3 2 2 2 0 0 0 3 1 2 1 0 0
0  2  0  2  2  0  2  1  3  3  1  3  2  3  2  3  0  0  2  0  3  2  0  1  1  1  1  3  2  3  2
0  0  1  1  0  0  0  1  0  0  3  0  0  3  0  0  2  0  1  2  1  2  1  2  0  2  0  0  0  2  0
1 2 1 1 0 0 3 1 2 1 0 2 1 2 2 3 2 0 3 2 3 3 1 0 1 2 0 3 1 2 2
3022032000301302031021323102300
0 2 1 0 3 1 2 3 1 2 3 0 3 2 1 1 1 2 2 3 2 3 1 2 2 0 3 1 3 0 2
1  0  3  0  0  2  0  2  2  1  2  0  3  1  2  3  1  0  2  3  0  2  1  3  2  1  0  2  0  1  0
3111122301320111231312003330122
1330121100022030312331203000112
2222003021323013333320223322210
0130231300013222320030130131300
0101011100110010010110000111110
