201231223210100
301020211033210
031011202203010
121211121201012
2  2  0  2  3  2  0  2  3  0  1  0  0  3  0
3 2 0 3 3 2 3 1 3 3 2 1 2 1 0
2 3 3 2 0 1 3 1 1 2 2 0 3 3 0
3  0  0  1  0  0  3  1  0  2  2  0  2  2  2
1 2 2 0 2 0 2 3 2 3 0 2 1 3 0
3  3  0  1  0  2  2  0  2  3  1  1  0  1  0
3 0 2 1 0 1 2 2 0 0 2 3 3 2 2
300110011013012
3  2  0  1  1  2  2  3  2  0  0  2  2  0  2
0 2 1 1 1 3 1 3 3 2 2 3 0 3 0
1  0  2  1  0  0  1  3  1  0  3  1  1  2  0
0 1 3 1 2 2 0 0 1 3 2 0 3 0 0
1  0  0  1  0  3  1  3  3  1  3  0  1  3  0
223233210231230
300213133303212
213202302212320
3 3 0 2 1 2 1 1 3 2 3 1 0 3 0
333120130210212
2  3  2  3  3  2  2  0  3  2  1  3  1  2  0
232001130322112
2 0 3 1 3 2 3 3 0 2 1 1 3 1 2
0  0  3  3  3  0  0  0  0  3  2  2  0  1  2
300031001121112
1  1  1  2  1  1  0  3  3  1  2  0  1  3  2
010101101011000
