2301033012010
3032331113212
0 3 3 1 1 1 0 3 3 3 1 2 2
1  3  2  0  2  3  3  3  3  3  0  1  0
0  3  1  2  0  0  3  0  1  1  2  0  0
1  1  2  0  0  2  1  0  3  3  0  3  0
1002133123100
2011220212302
3303200020102
1  0  0  3  2  1  0  2  0  1  2  2  0
2  1  0  0  2  0  0  1  2  0  2  3  2
3  1  0  0  0  2  0  2  0  3  2  0  0
0  0  3  3  3  0  2  2  1  3  3  1  2
1323130222110
1 3 1 0 3 2 1 1 2 0 3 0 0
1300133011300
3323013101130
1313000122112
2 1 3 3 0 0 0 2 3 0 1 0 0
1  0  1  1  0  1  1  1  0  0  0  0  0
