0  3  2  1  1  1  3  3  2  2  0  2  1  2  2  3  1  3  2  0  2  3  0  3  3  0  1  1  3  2  3  1  2  1  0  2
301213022320320120223002220101203200
1  0  1  1  0  3  2  1  3  3  3  2  0  1  1  3  1  2  1  1  2  0  3  2  2  0  0  2  0  3  3  3  1  3  1  0
1 1 2 3 0 1 3 3 3 0 3 3 1 0 0 3 2 2 1 0 0 2 1 3 3 0 2 3 0 0 3 3 2 3 3 2
121232131020011120000331233102100000
3 3 2 1 3 0 3 3 2 2 1 1 1 3 0 3 1 3 2 1 1 1 3 3 3 0 3 2 2 3 1 2 3 3 0 0
120031012303212202301311110131100232
303200233212220101030230301120112010
3  0  2  0  1  2  2  0  0  2  3  3  2  1  1  3  2  3  1  3  0  1  3  3  2  3  1  3  2  0  1  3  2  1  0  0
300002030303211033333320233100122330
2  3  1  3  0  1  1  1  2  3  0  1  2  0  3  1  0  3  2  0  2  1  2  0  0  3  3  0  1  1  0  1  1  3  2  0
0 1 3 3 2 3 2 3 3 3 0 0 1 2 2 2 3 2 3 0 2 1 3 0 3 2 1 2 3 1 2 3 0 0 1 0
3 1 0 1 1 2 3 0 0 1 2 1 3 2 0 3 3 2 3 1 0 3 2 2 1 3 1 1 0 1 1 0 1 2 3 2
1 0 2 1 0 1 0 3 3 0 3 3 0 1 0 0 1 1 1 3 0 2 3 0 2 0 1 0 2 1 1 3 2 1 3 0
3 0 1 0 2 2 3 2 2 2 3 1 1 1 1 3 0 2 3 2 2 0 3 2 0 0 3 1 1 2 1 0 2 0 0 0
2  2  1  3  3  1  0  2  2  2  2  1  0  2  2  3  1  0  2  1  0  0  3  1  0  2  1  0  2  0  0  2  3  3  3  0
0 0 2 3 3 0 3 3 2 3 3 0 1 3 3 0 2 0 0 1 2 2 1 2 3 0 2 3 3 3 3 0 0 2 2 2
0 0 2 2 3 0 2 2 2 0 3 0 1 3 2 1 2 2 3 1 2 1 1 0 1 3 1 3 0 1 0 0 1 3 2 2
302122222332110032133202233103110122
220132001002312303313031033131200032
2 1 3 0 1 1 3 0 3 3 1 2 0 0 2 3 3 2 0 3 1 1 1 3 0 1 0 1 1 1 0 1 0 0 0 0
121331221302100123001113030211320110
220100322313110230213032032300303210
3  1  0  2  3  3  3  0  0  0  0  2  1  1  2  0  0  0  2  0  0  0  0  2  2  0  1  1  3  3  0  0  2  1  3  2
0  1  0  1  1  1  1  0  1  1  1  0  1  0  1  1  1  1  1  1  1  0  0  1  1  0  1  1  0  0  1  1  1  0  1  0
