0 1 0 1 1 2 2 1 2 1 1 3 3 1 3 3 3 3 2 1 2 0 3 1 0 2 2 1 2
0 3 3 0 1 0 3 1 2 0 0 1 3 0 1 1 3 0 2 1 0 1 2 3 2 0 2 1 2
0 2 3 0 0 2 1 2 2 3 0 1 3 2 0 1 3 2 0 0 1 1 1 0 1 3 3 2 2
1  3  2  3  3  2  0  3  3  3  0  0  3  2  0  2  2  2  3  3  2  1  3  1  1  0  1  2  2
2 0 3 2 3 1 1 3 2 3 2 3 2 1 1 2 3 2 0 3 2 0 0 3 1 1 0 0 2
2  3  3  1  2  3  0  2  1  1  3  1  0  2  1  0  2  1  1  1  1  3  3  3  1  1  3  3  0
2 2 0 3 0 3 3 0 3 0 1 2 2 3 0 0 2 1 1 2 0 0 3 3 1 1 1 0 0
2  3  2  2  1  1  2  3  3  2  0  1  0  1  1  2  2  1  0  3  1  2  0  2  3  3  3  1  2
0  0  0  0  0  0  3  3  1  3  1  0  3  3  2  2  3  3  3  3  0  1  3  3  0  2  2  0  2
2 1 0 1 3 0 0 3 1 1 3 3 0 1 3 3 1 3 3 3 3 0 1 2 3 1 1 3 2
1  2  0  1  1  3  3  3  2  3  3  1  3  3  2  2  3  3  0  3  0  2  0  1  1  1  0  3  2
2 0 3 1 3 1 2 0 0 3 2 0 1 0 0 0 2 2 2 1 3 0 0 1 3 0 1 0 0
1 1 1 3 3 3 0 3 1 2 3 1 3 2 1 1 0 2 3 2 1 1 1 1 3 0 2 3 0
0 3 3 1 3 0 2 3 3 3 0 0 1 1 0 1 3 1 1 0 0 2 0 1 0 2 0 3 0
3  0  3  1  3  2  3  1  2  0  0  1  3  1  1  3  3  0  0  0  1  1  0  0  3  0  3  1  0
01120202130313230322223231320
0  0  0  0  1  3  0  2  1  0  1  3  1  1  3  1  3  3  0  3  3  2  3  1  3  0  3  1  2
2  2  1  0  1  2  0  2  3  2  0  1  0  0  1  1  1  3  1  3  3  3  3  2  2  3  3  3  0
31033110003312232130220200010
01321333220203310232213212120
2 1 1 1 3 1 1 0 3 2 1 2 0 2 1 1 3 1 0 2 0 1 1 2 3 3 0 2 0
01210011123302112323322133020
21203100333123312110220221210
0 0 1 0 0 1 3 2 1 1 1 0 1 3 0 3 3 0 1 3 0 0 3 1 2 3 2 0 2
1 0 0 0 1 0 0 1 0 0 0 1 1 1 0 0 0 0 1 0 0 0 1 1 0 1 1 1 0
