3101203320
2  1  0  1  1  2  2  0  0  2
2213120232
0110120322
2 0 1 1 3 0 3 0 1 2
1  3  3  3  2  0  1  1  0  2
2 1 3 1 1 2 0 0 0 0
3 0 3 1 0 0 2 1 1 0
0303001232
0  0  2  2  2  0  2  2  2  2
1 2 1 0 3 2 0 0 3 0
1  2  1  2  1  2  1  1  1  0
3 0 1 2 1 3 1 1 0 0
2  1  2  1  0  1  3  1  0  0
0 2 2 3 0 3 3 3 3 0
3100031320
0011110010
