3  3  1  0  2  3  1  0  1  2  0  2  1  0  0  2  2  0  3  3  2  1  0
2 3 3 2 3 3 3 0 2 3 0 2 2 0 2 0 1 1 1 1 3 3 0
1 0 1 1 0 3 0 2 0 3 0 3 2 0 2 0 2 0 0 0 3 3 2
10231232230110013023100
0 3 2 1 0 0 3 0 3 2 3 1 0 1 0 1 0 3 2 2 3 2 2
2 0 2 2 2 2 3 3 0 3 3 1 3 3 2 2 3 1 0 1 2 1 2
21032012020110123110102
2  2  3  0  1  0  3  2  2  1  3  0  1  0  2  3  2  0  3  3  2  3  0
0 1 3 0 0 0 3 1 1 2 0 1 2 1 3 2 3 2 3 1 3 2 0
2 2 2 0 1 1 3 0 0 1 0 0 3 3 0 3 0 0 1 0 3 3 0
2  0  0  1  1  3  0  0  3  0  1  0  3  0  0  2  2  1  0  0  1  3  0
02210123220222232330232
3  2  3  3  1  1  2  3  3  2  1  0  1  2  1  2  0  0  2  2  1  1  2
03010003031023322231022
0  3  2  1  0  2  0  2  0  3  1  0  2  1  3  2  0  2  1  1  1  2  0
1 1 2 1 1 1 2 3 2 0 2 3 0 3 1 2 0 3 1 2 1 2 2
23030203002022113212100
3  2  3  3  0  1  3  1  0  0  3  2  3  1  0  1  0  0  0  1  1  0  0
2  1  2  0  3  1  3  0  0  2  0  0  2  1  3  0  2  0  3  3  2  1  0
1 3 0 0 0 0 1 0 3 0 3 1 0 3 0 3 3 0 0 1 1 0 2
13302120210033033110030
11101332102021013120302
21200202300211102220212
2 0 2 2 1 1 2 2 1 0 2 0 3 0 0 3 3 3 2 1 1 1 2
2  2  0  1  3  3  1  1  2  2  3  3  2  3  1  1  0  2  3  2  2  2  0
12130203133131321000322
1 0 3 2 1 0 2 2 3 3 2 0 2 1 3 2 2 2 2 0 1 1 2
11010110110000000001010
