103101013023321220
1  1  1  3  1  1  1  1  2  1  1  2  2  0  2  3  1  2
2  1  1  1  0  0  1  0  1  3  0  2  2  0  1  2  1  2
1 2 1 0 0 2 0 2 0 0 2 0 3 2 1 1 1 2
3  0  2  1  3  2  3  2  3  2  3  1  1  3  1  3  2  0
0  0  1  0  0  0  0  3  2  1  3  0  0  2  2  0  2  2
1 0 3 1 1 1 2 1 1 2 3 0 2 1 0 3 2 2
2 1 2 1 2 1 0 2 2 3 2 2 0 0 0 2 1 2
003210011301111000
1 3 3 2 2 1 1 1 2 2 2 3 2 0 1 3 1 0
230211310203332232
1  0  3  0  1  1  0  3  2  3  1  1  3  1  2  0  0  2
1 1 1 1 1 0 2 1 0 0 1 1 3 1 0 3 0 0
011310021322002122
213333312112033112
110110111001110100
