02011011302132301030
20213002000300101030
10122322032012331200
23102212130030103212
23233101121121103212
1  1  0  2  1  3  3  1  1  0  1  0  2  1  2  0  2  0  0  2
02321003332201002332
22320001120033110310
23132113023233223302
11123310302011310302
20311032131033033310
0  0  0  2  1  2  1  2  2  3  3  3  1  2  0  0  2  0  2  0
3  3  3  3  2  1  1  0  2  3  3  2  0  3  3  1  3  1  0  0
22213021330130022230
3  3  3  1  1  3  3  0  2  1  0  2  1  1  0  0  1  3  3  2
22231013321301011330
12321020003122321000
20102003321002123300
0  1  1  3  0  0  0  3  1  0  0  3  1  2  2  3  2  2  1  0
3  0  1  0  3  0  3  0  0  0  2  3  3  0  3  3  3  1  3  0
0 1 2 1 1 2 3 0 3 1 1 2 0 2 3 3 3 2 0 2
1  0  1  0  2  0  2  0  0  1  3  2  0  2  2  0  2  0  2  2
23333012011321011302
12333303203222220230
03132002130111310200
10011011111010110000
