2 0 3 1 3 0 2 2 2 1 0 1 3 1 1 0 2 1 2 3 2 0 3 3 2 0 2 3 0 2
323131220001330022221300330000
1  3  1  0  0  0  3  1  1  0  3  0  3  0  3  0  0  1  0  2  2  3  3  0  0  1  3  2  0  2
121212003313011300213111330132
3 2 2 3 3 2 1 3 2 2 3 1 2 3 1 3 0 3 1 2 3 0 1 0 0 2 1 0 3 0
2 1 1 1 3 2 3 2 0 1 0 1 0 1 1 0 2 2 2 1 1 2 0 3 1 0 3 0 0 2
3 0 0 2 0 2 2 1 2 0 1 2 0 1 2 0 3 1 3 1 3 0 2 2 0 3 1 3 0 0
323332201201130102031000221330
0 2 3 3 0 2 2 2 1 1 0 0 0 3 0 2 0 2 1 2 0 0 0 3 2 2 1 1 3 0
1  3  2  1  1  1  1  3  3  2  1  3  1  0  2  0  0  3  1  2  0  3  3  1  0  3  3  3  1  0
110021320032302123002010212220
0  2  2  3  2  3  1  0  0  0  0  2  0  2  2  2  3  1  1  3  2  1  1  3  2  0  0  3  3  2
3 2 3 1 2 2 2 1 3 0 1 3 2 3 3 1 3 1 0 3 3 3 3 3 0 3 2 3 2 0
122203112321320331002001233300
2  1  1  0  1  0  2  0  2  3  2  2  0  3  3  0  2  1  3  2  1  2  1  3  3  3  0  1  0  0
331112111000202023113333301300
201121102133130002313000331132
2  0  3  0  2  0  1  3  3  0  3  1  2  2  2  3  2  0  2  0  0  0  0  1  0  1  1  3  1  2
230230033312332133102101223222
3  1  0  2  1  2  0  2  0  2  2  3  0  2  2  3  0  1  3  0  0  2  0  0  2  2  1  2  2  0
003313120221313123033110331202
3 1 0 0 3 2 3 0 1 2 0 0 0 3 0 3 2 2 3 3 2 0 3 3 2 1 3 2 0 2
003102213231231100223120322132
202323000233220313333010201030
1 3 0 2 3 0 0 3 0 3 0 0 3 3 1 1 3 3 3 0 2 0 0 3 0 3 2 1 0 2
302203120323211021022030021122
1  3  3  3  3  0  1  2  3  1  2  3  3  0  2  1  2  3  1  1  3  1  1  2  3  0  2  1  1  0
3  2  3  0  0  3  2  2  0  0  3  2  2  0  0  2  0  3  2  2  0  2  2  2  2  2  2  2  1  0
3 0 0 2 2 1 3 2 2 0 2 3 0 0 1 0 0 1 0 0 0 3 0 2 1 2 3 2 2 2
0  0  1  3  3  3  3  3  3  3  3  1  1  2  0  2  3  2  2  3  3  1  3  3  3  3  0  3  2  0
1 1 1 1 1 0 0 0 0 0 1 1 0 0 1 0 1 1 1 1 0 1 1 1 0 0 1 0 1 0
