3  3  0  0  1  1  3  1  2  2  0  2  0  3  1  0  0  1  1  3  1  2  0  0  2  1  2  3  2  3  2  1  3  3  0  0  1  1  0  2  0
00303101003211313012223203310213122212122
01020233230230023123301110213221111131130
0 0 1 0 3 0 1 2 2 2 0 3 0 3 0 1 0 0 1 1 1 0 0 1 0 0 0 1 1 0 1 0 2 3 1 1 0 2 3 0 0
0 2 1 3 3 3 1 1 2 3 0 3 3 0 3 1 2 0 0 3 3 3 0 0 2 1 1 0 0 3 3 1 2 1 1 1 2 3 1 0 0
31330000200313223130233221011200000332112
0  0  2  1  3  2  0  2  3  1  3  0  1  1  2  2  3  3  1  2  3  2  2  2  0  3  1  3  2  2  2  2  2  0  3  1  0  3  1  2  0
01113220231031303211112232223333030111020
1 1 0 3 1 2 3 3 2 1 3 0 2 0 0 2 1 3 1 0 0 3 2 0 3 2 3 1 0 1 2 2 2 1 1 2 3 3 0 0 2
12202313232301333021102220133210002003330
00001110010110011001110101111101010101010
