3 1 3 1 1 0 3 0 2 2 2 3 1 1 2 3 2 0 1 0 3 2 1 3 2 1 3 3 1 0 1 2 1 2 3 2 2
2323201023022313020221130211032310132
3 3 3 2 3 3 1 0 2 2 0 3 0 2 2 2 1 1 0 1 1 1 3 0 0 3 1 0 1 2 2 3 3 1 0 0 0
3 1 3 0 2 1 0 3 2 0 1 0 1 2 3 2 3 1 1 3 2 1 2 0 3 3 0 0 0 2 2 3 2 0 1 0 2
3 3 3 1 0 1 3 2 1 3 3 3 1 2 2 2 2 1 1 3 1 2 2 1 3 0 0 3 0 3 0 3 1 3 2 2 0
2120230230231331032312130213131200332
2  2  1  1  3  2  0  3  3  2  0  1  3  3  3  3  3  1  0  2  1  3  2  0  1  3  0  0  1  0  1  3  2  1  3  2  0
3 0 2 3 0 0 1 3 0 1 1 1 3 2 1 3 1 1 1 3 3 1 0 0 0 3 3 0 0 3 3 0 0 3 1 3 2
1301120112113021212122120030211232212
0 2 3 0 1 1 1 0 1 3 2 0 0 3 1 0 3 2 0 3 3 2 0 3 0 3 0 1 2 2 1 1 0 1 2 2 2
2203133032013133200110031032312232230
1  2  1  0  0  2  0  0  0  0  3  0  1  2  2  2  2  2  3  3  1  3  3  2  0  0  0  3  1  0  1  2  2  0  0  3  0
0 2 0 2 1 0 1 0 0 0 2 3 1 1 1 3 1 0 0 1 0 1 0 1 0 1 3 1 2 0 0 2 1 2 3 1 2
1 1 3 3 1 0 0 2 0 0 1 3 0 3 2 3 2 3 1 0 1 0 2 3 0 3 2 3 2 3 0 1 2 2 2 1 2
2  3  0  1  1  2  3  3  0  0  2  3  2  0  1  3  2  1  3  3  2  1  1  2  0  3  2  1  1  2  1  3  3  3  1  2  2
1  1  3  3  1  2  1  0  3  1  1  1  2  2  3  1  2  2  1  0  1  3  1  3  1  1  1  0  2  0  3  2  2  1  3  0  2
1322100222113133012120023101230001102
0201001112000331313300123103130010322
2131332322100023032113303123013302232
0210033122132030232203210220133303010
3230033032320331031011113302012023302
0  1  0  0  0  0  0  0  0  1  0  0  1  0  0  0  0  1  0  1  0  0  1  1  0  1  1  0  1  0  1  0  1  1  1  1  0
