220302032132022023213030233330
2  3  2  0  3  3  1  2  0  0  1  2  0  0  3  3  2  2  0  2  0  2  2  2  0  2  2  0  0  2
3  2  3  3  1  2  1  2  0  0  3  1  2  1  2  2  0  1  3  2  3  3  2  2  1  0  3  2  2  2
100120213301232201003131021110
1  0  0  1  1  2  3  3  2  1  2  1  0  2  1  2  0  2  0  0  1  2  0  1  3  2  0  2  1  2
111133110030201221121032030300
1  0  1  2  3  3  1  3  1  0  3  0  3  2  1  3  0  0  1  3  3  1  0  0  0  2  1  1  2  0
032330113333011300322220003000
0  0  1  1  2  0  3  3  2  0  2  3  1  1  0  3  3  3  0  1  1  3  0  0  1  2  1  2  1  2
212231010203130033021212110002
3 0 3 0 1 3 0 3 1 0 2 2 3 2 0 3 1 0 0 2 0 0 1 3 3 0 0 1 2 0
330030232123210222112302120310
2  3  2  0  1  2  2  1  3  0  2  3  3  3  0  1  1  0  0  1  3  3  1  1  2  3  3  1  0  0
123033330123102221101122300202
311310311200110003130130312330
022102301033031223101123001112
201200110000033013101221010330
020200332113022222300313130212
033112121210131011231110330002
3  1  2  2  3  1  3  0  0  3  3  1  2  1  2  1  0  0  0  3  2  1  3  3  0  3  1  0  1  2
101101312221030333322203210312
3 2 1 3 2 0 1 3 2 1 2 1 3 2 3 2 0 2 2 1 1 0 2 1 0 1 0 2 3 0
2 3 3 2 2 1 1 2 1 3 1 2 1 0 0 1 1 3 0 2 3 3 3 0 1 0 2 0 0 0
1 1 2 1 2 2 3 2 2 0 2 1 2 3 0 3 3 0 0 1 1 2 3 3 2 2 2 3 1 0
100101100111100001110011001010
