02203001000202121300013213112120
2 2 2 3 0 2 0 2 1 1 2 0 3 2 3 3 2 1 2 1 2 3 2 3 2 0 2 2 0 1 3 0
3 0 0 3 3 2 1 3 2 1 3 1 1 0 1 0 3 0 0 1 1 0 2 3 1 3 2 3 2 1 1 2
00131101200112120110130110320030
3 3 2 0 1 0 0 3 2 1 1 3 2 2 2 2 2 2 1 0 3 3 1 0 3 1 3 1 1 1 2 2
21131330230333033221101310231310
3 1 3 2 0 3 2 0 1 2 1 3 1 3 0 3 1 0 1 2 2 3 1 0 0 3 2 3 3 2 0 2
11133220302110031010213110313112
23322110111203202013323302332310
1  0  2  3  3  1  1  3  1  3  3  0  3  0  0  0  2  2  2  0  2  3  2  0  1  3  0  1  2  0  1  0
3 3 0 3 2 1 2 3 0 1 2 2 3 1 1 1 0 3 1 2 0 1 2 1 2 2 2 2 3 2 0 0
0 3 3 2 3 1 0 0 0 2 0 2 1 1 0 3 3 0 2 1 1 0 3 2 0 0 0 0 3 0 2 0
3 3 2 0 3 0 3 2 1 2 2 1 3 1 1 3 2 2 0 1 2 1 3 0 0 2 2 2 1 2 1 0
30003203112301033132332221030032
0  3  0  3  2  2  1  0  2  0  0  2  2  1  0  0  2  0  1  1  1  3  1  3  0  2  1  3  3  2  3  0
0  1  1  0  1  1  1  0  0  1  0  1  1  1  0  0  0  0  0  0  1  1  1  0  1  1  0  0  0  0  1  0
