3 3 1 2 1 1 0 2 3 3 2 0 1 3 3 0 1 0 3 0 1 0 1 1 2 0 2 2 1 2 1 2 3 0 2 3 3 0
3  3  3  3  0  3  1  0  0  3  0  3  2  2  2  0  3  0  0  1  2  2  1  3  2  1  1  0  3  1  3  2  0  2  2  3  3  2
20333022320210313002102010221112211332
2  3  0  3  3  3  3  2  1  3  1  1  2  0  0  3  0  2  0  3  0  0  1  1  3  1  1  0  2  3  1  2  2  1  3  0  3  0
2 1 1 2 1 1 3 0 1 3 2 3 0 0 2 3 0 2 0 1 3 2 0 1 0 0 1 1 2 3 3 1 2 3 1 2 2 2
1  3  1  3  2  0  2  2  2  1  0  0  2  1  0  1  1  2  0  1  1  1  1  3  1  3  2  2  0  1  2  1  0  3  1  3  0  2
32231211013120323211300223331230100200
3  2  0  0  0  1  2  3  0  2  3  1  0  2  2  0  1  0  3  1  0  2  1  2  0  0  3  2  2  0  3  3  3  3  2  2  0  0
02130003130213213011232123132100300202
1 1 3 1 3 0 3 2 1 1 0 2 0 3 2 2 1 2 0 3 1 3 0 0 2 1 2 3 0 0 1 3 2 1 1 3 1 0
32101203031232222120000311010100031010
0  1  1  3  1  1  3  3  2  1  3  3  0  3  3  3  0  2  3  0  1  0  3  3  2  2  3  1  3  1  2  0  3  0  0  3  2  2
11011111100100100100011111010100101010
