3  1  3  2  3  3  0  1  2  2  2  2  1  0  1  3  3  3  0  3  0  1  0  0  2  3  3  0  2  2  1  0
2 0 2 3 1 2 0 1 0 1 1 3 1 2 1 2 1 2 1 3 1 1 3 2 2 0 2 2 2 1 3 2
11021020301100023333111221120000
3 2 0 3 3 1 3 2 2 3 2 1 0 1 0 1 2 1 3 0 1 0 0 1 3 2 1 2 0 1 2 2
3 2 1 2 3 0 3 3 2 2 1 1 3 2 0 0 2 2 1 1 1 1 3 2 1 3 0 3 2 3 0 2
1 1 2 0 2 3 3 3 2 1 2 0 0 1 1 2 3 1 0 1 2 1 0 2 3 0 2 0 2 2 1 0
0 0 3 0 1 2 1 0 3 0 0 1 0 0 0 3 3 1 2 2 2 2 3 2 0 3 3 0 1 3 2 0
00303132313201222231003202031110
2 0 0 0 3 0 0 0 1 2 0 1 2 2 3 2 3 2 0 2 2 3 1 1 0 2 1 0 0 2 1 2
01101110023022211012301231230010
33320213133132002112303022123112
3  1  1  1  2  1  3  3  1  3  1  3  1  1  0  3  0  1  1  0  0  1  0  3  2  2  3  0  0  1  3  2
2  0  1  2  2  2  2  1  0  2  0  0  2  0  1  1  2  3  0  1  1  3  1  2  3  2  0  1  0  1  0  2
3 2 2 2 3 3 3 2 3 0 0 3 0 3 2 2 0 1 1 3 3 2 3 0 1 3 3 2 1 1 3 2
2 3 1 2 1 0 0 3 2 1 0 3 3 0 3 3 2 1 0 2 2 1 2 3 3 0 1 0 3 0 2 0
1  1  0  1  3  1  2  3  2  1  0  1  0  1  2  0  2  0  2  2  1  0  0  0  3  0  1  0  2  1  1  2
3 2 1 0 0 0 3 2 3 1 2 0 3 2 2 2 2 2 2 1 1 2 1 1 2 1 3 3 3 0 0 0
3 3 0 3 0 3 3 3 1 1 0 3 3 3 1 0 1 1 1 0 3 1 1 1 3 0 2 1 0 3 3 2
1 2 1 2 3 1 0 1 0 2 1 3 1 1 3 2 2 2 0 1 2 3 2 0 1 3 2 1 2 1 2 0
01232013201101202303333320012122
13032031333112323202102002112212
0 1 2 2 0 3 1 0 3 1 3 3 2 0 0 3 1 1 1 3 1 0 2 3 0 2 0 0 1 2 3 0
2 0 2 3 1 2 0 2 1 3 0 0 0 0 1 2 2 3 0 2 2 0 2 0 0 0 1 1 0 2 3 2
01101001100110110111010111000100
