0300330232101221212
3  2  2  0  1  1  1  1  0  2  3  2  0  2  0  2  1  1  2
3  1  0  2  1  3  2  0  2  2  1  0  2  0  3  2  2  3  0
0 1 0 3 2 1 1 2 0 2 1 2 2 2 3 3 3 1 2
1300102221013303020
1110313103132301212
2112020310033233120
3 3 0 1 0 1 0 3 0 0 2 3 1 2 2 1 1 3 2
1323123310200212202
1133110200012012022
3301131111200221102
3 0 1 3 1 3 2 3 2 2 2 2 1 0 3 1 0 3 0
1  3  0  1  2  1  2  3  0  2  1  1  1  0  2  0  1  1  2
2 1 1 1 0 1 1 2 3 3 1 2 3 0 0 3 3 2 2
0 2 2 1 3 1 2 3 0 0 3 3 1 3 2 1 0 1 0
0020322132220301132
0313133202131310230
3 3 1 0 1 1 2 1 0 0 0 0 3 1 1 3 0 0 2
3  0  0  0  2  1  1  1  3  1  1  3  0  3  0  1  1  2  0
3  0  0  2  3  0  1  2  1  2  1  0  3  3  0  2  3  0  2
1  3  2  2  2  2  1  3  3  3  3  1  2  3  1  2  0  3  0
0303330220111301130
2  3  1  3  1  1  0  2  0  0  0  2  1  1  2  3  2  2  0
2  2  2  3  3  3  1  1  2  2  3  3  2  3  2  1  3  0  2
2131310132213323212
3113232031330112000
3132021132113112000
0  1  0  1  1  1  1  1  0  1  0  1  1  1  0  0  0  0  0
