1 3 1 3 3 1 1 0 2 1 2 0 0 1 2 1 0
23113002023333022
1 3 2 3 1 3 3 3 1 3 2 3 0 2 0 0 2
13102033212220210
0 2 2 1 1 1 3 0 0 1 1 1 2 2 3 3 2
30131021001023200
0  1  1  2  2  3  2  2  3  0  0  2  1  3  2  1  2
10300023022102322
0  3  0  3  1  3  0  0  2  3  1  2  2  1  1  1  0
31303301023233012
2 1 1 1 2 3 1 1 1 1 0 1 2 2 2 0 2
0  3  2  2  2  1  3  2  1  1  1  0  2  2  3  2  2
3  3  0  1  2  3  3  1  2  1  3  1  0  3  2  2  0
0 3 1 0 2 2 3 0 3 1 0 3 2 2 2 2 2
23030323113301032
1  0  0  0  1  0  0  0  1  1  0  0  0  1  1  0  0
