3 3 1 3 0 3 3 3 3 1 2 1 0 2 0 3 3 2 1 1 0 2 2 0 1 2 2 0
3 1 3 1 0 3 3 0 0 2 1 3 0 1 1 1 0 3 0 0 3 0 3 3 3 1 2 0
1132300322201330012000230022
2 2 0 0 0 2 2 3 0 1 0 3 1 0 1 0 1 2 3 1 3 2 2 3 1 2 0 2
1  0  3  1  2  2  1  2  3  1  2  1  3  3  1  0  3  2  3  1  2  0  2  3  2  0  2  2
3  3  0  1  3  0  2  0  2  1  3  2  1  3  2  3  3  1  1  2  1  2  2  3  0  0  0  2
0  3  3  0  1  3  3  2  3  0  1  2  3  2  2  2  1  0  2  1  0  1  2  2  2  3  2  0
3  1  0  2  2  0  1  0  3  0  0  3  2  0  3  0  0  3  2  2  3  3  1  2  0  0  3  2
2020112232023201333213011212
0 1 2 3 3 1 1 3 3 3 1 1 1 0 2 3 1 2 2 2 1 0 3 3 2 2 1 2
1  3  3  1  3  2  0  1  1  0  1  0  1  2  2  3  3  0  3  1  2  2  2  0  0  0  2  2
3130102110120002211201300112
3  0  3  1  0  0  2  3  0  1  1  3  0  2  0  3  2  3  0  0  1  2  2  3  0  2  2  0
1  0  0  3  1  2  3  1  0  1  1  1  3  0  1  3  3  1  0  1  2  2  2  0  0  2  2  2
1  3  2  0  0  2  2  3  1  2  2  0  3  3  1  3  3  0  0  0  1  1  2  3  1  1  3  0
2  2  3  3  1  1  1  1  2  2  1  2  2  2  1  1  0  2  3  2  1  2  0  2  0  1  2  2
0 0 0 3 3 2 1 0 0 3 2 2 3 3 0 2 0 3 3 0 1 2 2 3 3 1 3 2
2222122210300101131012100232
3 2 1 0 2 3 0 0 0 1 0 0 1 1 0 0 1 3 2 0 1 1 3 0 3 0 3 2
2  2  3  1  3  1  1  0  2  1  2  2  0  2  0  1  1  2  2  2  2  1  1  3  2  3  1  2
0 0 3 3 2 2 3 2 1 1 0 2 2 0 0 2 1 0 1 0 2 3 0 3 1 0 0 2
1233300020333003231033121210
0  2  1  3  2  0  3  0  3  2  2  2  0  0  2  2  1  0  3  1  3  3  3  0  0  1  3  0
0101001010100001100001010100
