021301233133221012313300
330221022033222212300300
0  2  3  3  2  0  0  1  1  3  3  2  0  1  2  3  3  1  2  1  0  2  0  2
1  0  3  2  0  1  2  3  1  3  1  2  3  0  0  1  2  0  2  3  2  1  0  2
223302003212001310332010
2 3 1 0 0 0 0 3 1 0 0 1 0 1 0 3 2 2 3 0 2 2 0 0
0 2 3 3 1 2 1 1 1 1 2 3 0 0 1 1 2 1 0 3 2 3 2 0
323223303032330313311222
1 0 3 3 3 2 3 0 1 1 1 0 0 0 3 2 2 3 0 3 2 1 3 2
1 1 3 0 0 1 3 2 0 0 0 3 2 0 0 2 0 0 3 2 2 2 0 0
101110110010000110000000
