3  0  3  2  2  1  3  0  1  2  1  0  3  0  2  3  0  1  0  0  1  2  2  1  0  1  2  1  3  1  1  0  3  1  3  0  3  2  0
302232003110121033333200031100033203230
1  1  0  2  2  1  1  1  1  0  1  2  3  3  0  1  2  2  1  1  3  2  2  0  3  0  1  2  0  0  2  3  0  3  1  1  3  3  2
112131322301232130113033202331111312130
3 3 3 1 0 0 2 3 2 1 1 0 3 0 3 0 3 1 3 1 2 3 1 0 3 3 3 2 3 3 2 2 1 2 3 0 3 3 2
330210320222123232232131131101031321100
200212020311211130131220322223331032210
2 3 0 2 2 3 0 3 3 2 3 3 2 2 2 2 2 1 3 1 0 1 3 0 2 2 2 0 0 1 0 1 1 3 1 3 0 1 0
303231003210100233211302123202103013130
121333311120303230223202302120103212120
222320221123102102310101321222131012030
3 3 3 3 3 1 3 3 2 0 2 1 2 3 1 3 3 1 3 0 0 2 2 2 3 3 0 0 2 1 1 0 3 2 2 1 0 3 0
203023201033130022312013023222210003010
1  2  3  1  2  2  2  1  3  3  3  3  2  1  2  2  0  3  0  1  2  3  1  1  0  2  0  0  3  3  3  3  0  2  2  0  1  2  2
013202202131101101211110120332211023230
101032113333022122212133220223321022202
1  0  1  1  2  3  1  0  3  2  0  0  2  2  0  1  3  0  1  2  0  2  0  2  3  3  2  0  1  3  2  1  0  0  0  2  3  1  0
203031331303220322012333203002001011000
3 2 3 0 2 2 1 2 0 1 2 1 1 2 1 1 1 0 2 1 0 1 0 3 3 0 3 2 2 0 2 1 1 2 2 0 0 1 0
2 2 2 3 2 2 2 1 2 3 2 1 3 3 0 1 0 3 3 1 1 0 2 1 1 0 2 3 0 0 1 0 3 0 3 3 1 2 0
002210333310002123212222133030222002132
302301111312112201121223111301332313232
2 1 0 2 1 2 0 3 3 2 2 2 1 1 3 1 2 3 3 3 2 1 0 3 1 1 2 3 0 0 0 2 3 3 0 0 3 1 2
3  3  3  2  1  2  3  0  2  0  0  1  1  0  3  1  3  1  1  2  3  3  0  3  1  3  3  3  3  2  3  0  3  3  1  1  1  0  2
023202133011123321031101023332302111112
2 0 3 1 3 1 0 2 0 3 0 3 2 3 2 3 1 3 2 0 0 2 3 1 2 2 2 2 0 1 1 0 1 1 3 3 1 0 0
2 2 0 1 1 1 1 0 3 1 1 0 0 3 2 3 3 2 0 3 1 3 0 0 3 3 2 2 3 1 0 3 2 3 0 2 0 2 0
011101110101110100001101010111011001000
