0  3  1  0  0  1  2  1  1  2  0  2  1  2  1  3  2  2
101013121230312220
110022321331310210
132210010002011320
311012113002103330
130312113001012320
1  3  0  0  0  3  0  3  0  3  0  2  1  1  3  3  1  2
013221012021031332
3  1  2  3  0  0  0  3  3  0  3  2  2  3  2  1  0  0
1  3  0  2  2  0  2  2  2  1  2  2  3  3  3  3  0  2
1 3 2 2 1 0 1 3 0 3 3 3 3 2 3 2 2 2
0 3 2 3 3 1 0 2 2 1 3 2 2 2 3 1 3 0
3 0 3 2 1 3 0 1 3 3 0 0 1 3 0 0 2 2
1 1 3 2 2 3 3 1 3 1 2 3 2 2 3 2 2 2
0 2 2 0 2 0 0 2 3 2 2 2 1 1 2 2 1 0
221122321232002112
2 1 3 2 3 2 2 1 2 0 0 1 2 3 1 1 2 0
002101020013210022
101321002223320332
0  2  0  3  2  3  3  3  3  2  1  1  3  2  3  2  2  0
0  3  2  3  2  1  2  3  3  3  2  3  0  1  2  1  0  0
0 0 1 1 0 0 1 0 1 1 1 0 1 1 0 0 1 0
