2 1 0 2 1 2 3 0 1 2 1 1 1 1 1 1 1 1 2 3 0 2 3 1 2 1 3 1 0 1 3 0
1 2 2 1 3 3 1 3 1 1 1 0 0 0 2 1 0 3 2 3 0 3 2 3 2 1 2 1 1 3 2 0
3  1  1  3  3  3  2  0  1  0  0  0  3  3  0  1  3  2  2  1  0  2  2  1  2  1  1  1  3  3  3  2
20300113211332312212200132000202
03102113230132003221010322031122
3  3  2  0  1  0  1  2  2  0  0  2  1  1  1  1  1  0  3  3  3  2  0  2  2  3  1  0  3  1  0  2
32101213313312131112123210030300
2 0 0 1 1 0 3 2 1 0 1 1 1 3 3 2 1 0 2 1 0 2 2 2 2 2 1 1 2 3 3 2
0 0 1 3 0 3 3 0 1 2 1 3 3 1 0 0 1 0 2 3 2 1 2 1 2 3 2 3 0 1 3 0
3  2  3  2  1  2  0  0  3  3  1  2  0  0  3  2  3  0  0  1  1  3  3  1  0  1  2  3  3  2  1  2
03320222323200013331233231233112
2 3 0 0 1 0 3 1 1 2 0 2 1 1 2 1 0 2 0 0 1 0 3 0 2 0 2 3 3 1 0 2
21020130121032330100220013210232
11333222233312213121131212312012
00230003231031311033030122332000
3  2  3  0  3  1  2  3  2  0  3  3  3  3  3  0  1  2  2  2  2  1  0  0  3  2  3  2  2  1  0  2
0 0 2 3 1 3 1 1 1 0 3 2 3 3 2 0 2 2 3 1 3 3 0 3 1 1 3 1 3 2 2 2
3  0  1  0  1  1  2  0  1  2  0  1  3  0  1  0  1  2  3  0  0  1  1  2  1  2  0  1  2  2  0  0
01220320120130102203330010010210
22200221131031201030123321021112
0 0 3 1 1 0 0 1 3 3 0 0 0 0 1 2 2 3 1 1 2 2 1 3 2 0 0 2 1 2 3 0
3  1  3  2  3  0  3  1  3  2  3  3  2  2  1  3  2  2  0  1  1  0  1  2  2  0  0  0  0  2  2  2
02111102210301202210323033310302
3  3  0  3  1  1  1  2  2  2  3  0  1  3  0  3  0  1  3  1  3  1  0  0  1  3  1  1  1  3  2  2
2 2 2 3 1 0 2 2 3 1 1 2 2 3 3 3 1 0 3 0 3 3 0 2 2 2 3 1 1 2 3 0
01100001011001011011000001101010
