210000101132310301011222100
2  0  3  3  1  1  1  2  1  2  3  2  0  3  3  3  0  3  2  3  0  3  3  1  0  1  0
222133013312123222212213132
2  2  1  1  2  1  2  3  1  0  0  0  2  1  2  3  2  3  2  1  2  1  2  1  2  3  2
3  2  2  2  3  3  2  2  0  2  3  2  1  3  1  0  0  1  0  2  2  3  3  2  3  3  2
110130230112032113111310230
0  1  3  2  0  2  2  1  2  1  1  2  3  2  0  2  2  3  2  2  2  3  3  1  0  3  0
3  1  1  0  1  2  2  2  3  0  2  0  3  1  1  1  0  2  1  1  3  2  0  3  0  3  2
1 0 2 0 1 2 2 2 0 3 2 3 0 2 3 3 0 2 2 1 1 0 1 0 3 1 2
2  1  1  2  1  1  3  2  3  0  2  0  1  0  1  0  1  1  0  1  1  3  1  1  1  0  2
3 3 1 2 3 1 3 3 1 2 3 3 3 2 3 3 0 3 1 2 1 0 1 2 1 3 2
110100101000101100001110000
