3 0 1 0 2 3 1 3 2 1 1 3 3 2 0 1 3 2 1 3 0 3 0 0 3 1 3 2
2021202121313132011321231000
2320021102321002013132011130
3  0  2  3  3  0  3  0  0  2  1  1  3  3  2  1  2  0  2  0  1  0  2  2  1  0  3  2
3120021020300123320200002222
2  0  2  0  2  3  3  1  1  3  3  0  1  1  1  3  2  3  3  2  1  0  0  1  0  0  2  2
2 2 3 2 3 3 3 2 1 3 3 2 1 0 1 2 3 2 1 2 3 0 3 3 1 3 1 2
2 2 0 1 1 2 0 1 3 1 2 2 1 3 2 0 1 1 1 3 0 2 2 1 1 1 1 2
0  1  3  2  3  1  2  2  3  1  0  1  1  0  0  2  3  0  1  2  1  2  3  2  1  3  2  0
2120332202210311233211313310
1123212231002011002130222210
1 1 2 0 0 3 2 2 0 1 3 3 2 1 3 2 2 1 2 0 2 0 3 0 2 0 0 2
3303001210323313013300301030
3322131330030233210310213300
1  0  2  1  1  0  2  0  0  3  0  2  0  2  0  1  1  2  3  0  2  0  3  3  3  0  0  2
3 0 0 1 1 3 3 0 3 0 1 2 3 0 0 1 3 0 0 3 2 3 0 0 3 2 0 0
2 1 0 2 2 2 3 1 3 2 2 2 3 2 2 0 1 1 1 1 0 2 1 1 1 3 2 2
1 2 1 2 0 3 2 1 1 0 1 1 0 1 0 3 2 3 0 2 3 0 1 2 3 1 2 2
1211033022001003212101031332
1 0 0 0 0 0 1 0 0 1 1 0 1 1 1 0 1 0 0 1 0 1 1 1 1 0 0 0
