1 2 3 2 3 1 3 0 3 1 2 2 2
0  2  3  3  0  0  3  1  2  0  3  2  0
3330222220030
3 0 2 2 2 3 0 1 3 2 1 0 0
2 3 1 3 3 3 2 1 2 1 3 2 0
1 0 2 0 1 1 1 1 1 1 3 2 0
3100200133000
3 3 0 2 1 2 2 0 3 1 0 1 2
1  1  2  2  0  1  0  1  0  1  2  3  2
3 3 3 1 2 2 3 2 1 3 1 2 2
2  2  3  3  1  3  1  1  2  1  2  3  0
3031302331010
3323220211010
0  3  3  2  3  0  2  3  1  0  2  2  2
0213221202320
1332330213302
2 0 0 0 1 1 1 3 0 2 2 1 0
3  2  2  2  1  2  1  1  0  1  3  3  0
3220212222330
2  3  3  3  1  1  1  3  1  0  2  2  2
1032201313030
1  3  1  0  1  3  0  3  1  2  2  3  2
2  2  3  3  1  3  0  3  1  0  3  2  0
1 1 0 0 1 1 0 1 1 0 0 0 0
