0 3 2 2 0 1 2 2 2 3 2 2 2 2 3 1 3 3 0 2 0 1 2 3 2 3 1 3 3 0 0 3 0 1 0 1 3 3 1 2 0
3  1  0  3  1  2  1  1  2  1  0  1  1  1  1  0  2  0  1  2  1  1  1  3  0  2  3  2  1  1  1  3  0  0  1  1  1  1  1  1  2
3  3  1  1  3  2  2  2  2  2  2  0  3  3  3  0  0  3  3  0  1  0  0  2  2  2  3  3  0  1  2  0  3  2  2  1  3  2  3  3  2
20032130213033321020300323000313132022310
0 1 0 2 2 0 0 0 0 2 1 1 0 2 3 3 1 2 2 0 2 2 0 0 0 2 1 2 1 3 0 1 2 3 0 0 2 1 2 3 2
2 3 1 3 2 0 1 0 1 2 1 0 3 1 2 2 3 2 0 2 0 0 3 0 2 1 3 1 3 3 1 1 2 1 1 3 0 0 2 0 2
0 1 2 1 3 1 3 3 1 0 0 2 0 0 2 3 1 0 1 2 2 1 3 0 3 3 1 3 2 3 3 0 1 2 3 3 0 3 0 1 2
3 0 2 0 2 2 2 3 1 1 1 3 3 3 3 3 0 0 0 1 1 2 1 1 3 1 2 1 2 1 0 2 3 3 0 2 0 0 3 2 2
0  3  0  0  1  1  0  2  0  3  3  3  3  2  1  3  3  3  0  1  2  3  1  1  2  1  2  3  0  2  2  3  2  3  3  0  2  2  2  3  0
0  3  2  1  2  0  3  0  1  1  2  3  0  1  1  1  1  0  1  3  3  3  3  3  1  1  2  2  2  0  3  2  0  3  0  0  2  2  0  2  2
00021202031303000123203310230013010111000
3  1  1  1  1  3  1  3  2  0  1  1  1  0  1  1  0  2  3  3  3  2  3  0  2  1  3  1  2  2  1  2  2  1  2  3  0  0  3  3  2
12002231312233010021003121202121033332000
13302023112211232130022321002331122001302
2  0  2  2  2  2  2  3  1  0  1  0  0  2  2  0  3  3  0  1  2  0  0  2  1  1  3  2  0  0  0  2  1  1  2  3  3  3  0  2  2
2 0 1 2 1 1 2 1 2 3 3 1 0 2 2 2 2 1 0 0 0 2 2 2 0 3 2 0 2 1 3 0 0 0 1 2 2 2 2 0 0
2  1  1  1  3  0  2  0  2  2  0  1  0  1  1  1  2  0  2  0  0  1  0  2  2  1  0  2  3  3  2  2  3  3  3  2  2  0  1  0  0
31200131310331213012120120120021032333032
31111313130233110211302201310311023101330
2 0 3 3 3 2 1 1 1 2 2 0 2 3 2 0 0 2 2 3 2 2 2 0 2 3 0 3 0 0 3 2 0 0 1 3 0 1 2 1 0
13323213302221111123002233210313033221012
3 0 3 2 3 1 3 2 0 0 1 3 2 2 3 3 3 3 3 0 1 2 3 2 3 1 1 3 1 0 2 1 2 2 1 2 0 2 3 0 0
3 0 2 1 0 0 0 2 2 1 2 1 1 3 2 3 3 2 0 0 1 0 2 1 3 0 3 0 3 0 2 1 2 3 3 3 3 2 3 1 0
0 2 3 1 1 3 1 2 2 1 1 2 2 2 1 0 2 2 0 2 3 0 2 1 0 3 1 1 0 0 3 1 0 3 3 1 0 3 2 3 0
30002210031330321200300101102230302302010
0 0 0 1 1 1 1 0 0 1 0 1 1 0 1 0 0 0 0 0 0 1 0 0 1 1 1 1 0 0 1 0 1 0 0 0 1 0 1 1 0
