1322332021112201200201313221300220
1 3 1 0 3 3 2 0 2 3 2 3 0 1 0 1 1 3 1 1 3 3 1 2 3 1 0 1 1 1 2 3 1 2
3 0 3 3 3 2 1 2 1 0 3 0 0 3 0 3 0 1 0 1 1 3 3 2 2 1 1 1 2 1 2 1 0 2
0222111310211322122123103233302300
0 3 0 1 3 0 0 3 2 0 3 3 3 3 0 3 3 1 1 3 0 2 3 0 2 2 3 0 0 2 2 2 3 2
3021120022233023213100001021133110
1030122330321323313130021302123000
0020113130013330132310033001012322
2232313001210132101001102112030200
3 2 0 1 1 1 1 1 0 0 2 0 1 3 1 3 0 3 2 0 1 0 2 3 1 3 3 0 2 2 1 3 1 0
0313321232233123132033011002031232
3 1 1 0 1 3 1 3 0 0 1 0 1 3 3 0 3 2 2 3 0 0 0 1 0 1 1 2 0 2 0 3 2 0
3  2  0  1  1  1  0  2  1  3  3  1  3  1  1  1  1  3  2  3  3  2  3  2  3  0  2  2  1  2  1  3  3  0
1123221221110223202122230133003022
2 1 3 3 3 2 2 1 2 1 2 0 2 2 0 2 3 0 2 0 2 3 2 1 2 0 3 2 2 3 2 1 1 0
0  1  1  2  2  3  2  3  0  2  0  1  3  1  3  0  3  3  1  1  2  2  1  0  3  3  3  0  3  0  3  3  0  2
1  0  2  2  2  3  2  2  0  3  1  1  2  0  3  1  2  0  1  0  3  3  1  2  0  3  2  3  0  0  1  2  1  2
1  2  1  1  3  2  2  3  1  3  0  2  2  1  0  1  3  3  2  2  1  1  0  1  3  3  3  1  3  0  1  2  1  0
3 0 0 1 2 1 1 0 2 0 2 2 2 2 2 1 2 2 1 2 0 1 1 0 0 0 1 0 2 0 1 2 1 0
2 2 2 0 1 0 3 0 1 3 1 3 2 1 2 0 3 2 0 3 1 1 3 0 2 1 0 2 2 1 3 2 2 2
0 2 0 2 3 0 0 3 0 2 3 0 0 3 3 2 2 2 3 1 1 3 0 0 0 2 0 0 3 1 1 2 0 2
1  0  1  3  3  1  2  1  2  2  1  3  2  0  0  2  1  2  0  3  3  3  3  2  0  0  1  2  0  3  0  1  1  0
3  3  0  2  1  2  3  0  1  3  2  1  1  0  3  0  3  1  2  0  0  2  3  3  3  3  0  1  1  0  1  0  1  0
0 0 2 1 1 0 1 1 0 0 3 3 3 3 0 1 0 3 3 0 2 0 1 0 3 0 2 3 0 2 2 2 0 0
0310303202232132133032010021233002
0 3 1 1 3 1 2 2 2 0 3 3 0 2 3 1 3 2 3 0 0 2 3 0 1 1 3 0 3 2 3 2 0 0
1  0  2  2  1  2  2  3  3  3  2  1  2  1  3  2  3  1  2  1  1  1  3  3  1  3  3  2  0  0  3  2  3  0
3 2 1 2 3 1 1 2 1 3 2 3 2 0 1 0 3 3 2 1 1 1 0 1 3 2 0 0 3 0 0 1 2 2
1 0 2 0 2 2 1 3 3 1 1 1 2 1 1 3 2 3 3 1 2 0 0 1 2 1 1 1 2 1 3 0 1 0
1  0  0  0  1  1  0  0  1  1  0  1  0  0  1  1  0  0  1  1  1  0  1  0  1  1  1  1  1  0  1  1  0  0
