0  1  2  3  2  1  2  2  2  0  1  1  1  0  0  2  1  3  3  2  3  0  3  1  3  2  1  1  0  0  3  2  1  2  0  1  3  1  2
232211123323023231213331300332213332010
1 3 1 3 2 0 1 2 2 2 3 3 0 2 3 3 3 1 3 2 2 2 3 3 3 0 0 2 0 3 1 1 3 1 1 3 2 3 2
1 2 2 2 1 3 2 2 3 3 3 3 2 2 0 3 1 0 1 0 0 2 2 3 3 0 3 0 2 0 3 2 0 1 0 1 1 3 0
3 2 2 0 0 3 2 1 0 0 0 3 2 2 2 0 0 0 0 2 2 2 0 1 1 1 3 0 1 0 1 3 1 2 3 3 1 0 2
331233013132330210300033312032211032030
2  1  2  0  1  3  2  0  0  1  1  0  3  0  2  0  1  1  1  1  3  2  2  2  0  0  2  1  1  2  0  1  2  1  0  2  1  1  0
0  2  0  3  1  0  3  1  3  2  1  2  3  2  1  3  1  3  3  1  0  3  2  2  3  1  3  2  1  1  1  0  0  2  0  2  1  2  0
2  3  3  2  3  1  1  2  3  3  3  1  3  1  2  1  3  2  2  3  1  2  3  2  1  3  0  1  1  3  1  0  2  1  1  0  0  0  0
220033031102312111130332031001311333112
0  3  0  3  3  2  0  0  3  0  3  3  0  0  1  0  0  1  1  0  2  0  3  0  2  0  2  1  1  0  0  3  2  0  1  3  1  2  2
013202130102213312032021303223102202322
2  0  1  1  2  1  3  3  0  2  3  0  3  1  1  2  2  0  1  0  2  0  3  0  3  1  1  2  2  1  2  2  1  0  2  0  3  2  2
1 0 1 0 1 0 2 0 3 2 0 1 3 2 0 0 1 1 1 3 2 0 0 3 2 1 1 2 1 1 1 0 1 3 3 3 0 0 2
3 1 3 1 1 1 0 2 3 3 1 1 1 0 1 1 0 1 0 1 1 1 3 2 1 1 3 3 0 2 0 0 2 2 0 3 3 1 0
012220012131200300113021203203103113020
1 0 0 1 0 0 1 1 1 1 0 1 1 0 1 1 0 1 0 0 1 0 0 1 0 1 0 0 0 0 1 1 1 1 1 0 0 0 0
