3  2  0  2  1  3  2  3  3  1  3  1  2  1  2  3  1  3  3  1  3  2  3  2  1  0  0  1  2  1  2  2  0
001310322203322333233131202222300
1  3  3  3  2  2  3  0  0  0  1  1  3  0  3  0  3  3  3  2  3  3  0  2  0  3  2  0  2  0  0  3  0
1 3 3 3 0 3 3 1 3 1 0 3 1 1 2 2 3 3 1 1 3 3 2 0 2 1 2 1 1 0 0 1 2
0 3 0 0 1 3 3 2 3 1 0 3 1 0 3 0 3 1 1 0 3 2 0 0 2 3 1 0 2 1 3 1 2
000313100223110231022011023010232
0  2  1  1  2  1  3  0  2  0  1  1  3  2  1  0  2  2  1  2  2  3  2  3  0  3  1  2  2  0  1  3  2
0 3 1 2 3 0 0 2 0 2 1 1 1 2 1 3 1 3 1 1 2 2 3 2 1 3 3 1 1 2 0 0 0
0 2 3 0 0 0 0 2 3 0 0 2 3 2 3 2 3 0 3 3 0 0 3 2 0 1 1 3 3 1 3 0 0
002002003132012222113012211200210
0  0  2  2  0  0  2  2  3  3  1  3  0  3  0  1  3  3  3  1  2  1  2  1  3  0  2  3  3  2  1  1  0
2  2  1  2  3  3  0  1  1  2  3  3  3  1  1  0  0  2  0  3  2  0  1  3  0  1  3  1  1  1  2  0  0
3  0  2  1  1  3  2  0  3  3  1  3  0  2  3  2  0  3  2  3  2  2  0  0  2  0  2  1  0  2  1  3  2
1 0 1 2 0 0 3 1 2 3 1 3 2 0 0 0 2 2 2 1 0 3 0 3 0 2 1 2 0 3 3 0 2
3  3  3  0  0  2  2  1  1  1  3  0  3  2  0  2  0  3  0  1  0  3  3  3  0  1  0  3  1  2  3  1  0
2  3  0  0  2  2  0  2  3  2  3  2  0  1  2  1  0  3  3  1  3  1  1  1  0  3  3  1  2  1  1  2  2
323100322032110301031023021012012
1  2  2  3  3  0  0  1  0  1  1  0  1  1  0  2  0  0  0  1  3  0  2  0  3  1  2  1  3  1  1  1  0
131210301020211010232010013121300
1  3  1  0  2  2  1  0  1  2  1  0  0  2  3  0  2  1  0  1  0  0  2  0  1  2  1  1  2  3  2  0  0
023310232012010031100010310303322
3 2 2 2 0 0 1 2 3 2 3 3 2 1 0 0 3 1 1 3 1 1 3 0 3 3 3 1 3 0 3 0 0
223133102321233221311301112300102
3 0 1 1 1 2 1 3 1 2 0 3 0 2 1 0 3 2 3 2 3 1 2 2 2 2 3 2 3 0 3 0 2
0 2 0 3 1 1 2 0 3 3 0 1 2 0 2 1 2 1 2 0 1 1 2 0 3 2 3 0 3 2 2 2 2
203333132011303233013213013332232
1  0  1  0  1  1  1  0  0  1  0  0  1  1  0  0  0  0  1  0  0  0  0  0  1  0  0  1  0  1  0  0  0
