123310302203301032310
011010230132221011110
310223030101231203212
2  1  0  1  2  2  0  3  0  0  1  2  2  1  1  3  3  0  1  2  2
1  2  3  3  2  3  1  2  2  1  1  2  3  0  1  2  0  0  1  0  0
310301210323211322002
0 3 2 0 1 3 0 2 0 2 0 3 2 3 2 2 0 3 0 3 0
202021010112021323332
2 0 1 1 1 1 3 0 0 0 1 0 0 3 0 1 0 0 2 2 2
0  2  1  0  3  3  1  3  2  1  3  3  0  1  2  3  3  2  0  3  2
3  0  1  1  3  1  1  2  1  0  3  3  1  0  1  1  3  3  0  1  2
223101200200211331112
2 2 1 2 3 2 2 1 3 3 1 0 0 0 1 1 2 1 3 0 0
200113022122012231302
2 2 2 1 2 3 0 2 3 1 2 1 3 0 3 2 1 1 3 1 2
2  2  2  1  2  0  0  0  3  0  2  1  0  2  2  2  2  0  3  1  2
0  0  1  1  0  1  1  0  0  1  1  0  1  0  1  0  0  1  0  1  0
