3  3  2  3  3  0  0  3  1  3  0  3  2  0  1  1  2  3  1  0  2  0  0  3  2
3301120002030322310231212
0  1  0  2  2  2  2  2  1  1  1  2  3  3  3  1  0  3  3  1  3  0  2  3  0
3 3 3 3 1 2 0 3 0 3 2 2 0 2 3 0 1 0 0 3 2 0 2 3 2
0  2  3  3  1  0  1  2  3  2  3  3  3  0  2  2  0  1  0  1  0  1  3  1  0
2100020231212301230023022
3001102131232332000021112
3 3 2 0 0 3 0 3 1 0 3 0 1 2 0 0 0 3 3 3 1 0 3 0 0
1  1  3  3  1  0  3  2  0  3  1  0  1  2  3  1  2  1  1  3  1  2  2  2  2
3 0 0 3 2 3 3 1 2 1 0 2 3 2 3 3 2 1 2 0 1 1 0 3 2
0  0  2  3  0  2  3  3  0  1  2  3  2  2  2  3  0  3  1  3  0  3  1  0  2
1201102022133012003301030
0022131132333202020222200
2212203132331130302102302
2031001112322333010013310
3 0 2 1 1 3 1 3 0 1 0 0 0 1 3 1 2 3 3 1 2 3 1 1 0
0  0  1  1  0  1  0  1  1  0  1  1  1  1  0  1  0  1  1  0  0  1  0  1  0
