2 3 1 3 3 3 2 0 1 2 2 3 2 1 0 3 2
1 2 0 2 3 1 1 2 2 3 2 3 0 1 3 1 2
1 1 1 1 0 0 1 0 3 2 3 2 2 2 3 2 0
20230002312003020
0 3 3 0 0 0 3 1 2 2 1 3 2 1 3 2 2
2  0  1  1  2  3  0  0  1  3  0  0  1  3  3  1  0
03031303033203332
12100031230022230
12121233230320032
3  3  1  1  2  1  3  0  3  2  3  1  2  0  0  3  2
00130330300221312
23310212002101222
0 0 1 0 1 2 2 2 0 2 2 2 2 3 0 0 2
32123110023101120
1  2  3  3  2  2  1  1  3  1  2  1  1  3  0  3  0
1 0 0 1 1 1 1 0 0 1 0 1 0 0 1 0 0
