0121133030113332200103313210
1  3  1  0  0  1  2  1  1  1  2  3  1  2  1  3  2  2  2  2  1  3  3  3  1  0  0  2
3 3 2 2 2 3 0 0 3 2 2 2 3 2 1 2 3 3 1 0 0 3 1 3 2 2 1 2
2 0 0 0 2 0 3 3 0 0 0 1 3 1 0 2 1 2 0 2 0 0 0 0 1 0 2 0
1  0  1  0  1  3  1  2  0  3  3  0  2  1  3  3  3  0  3  1  1  2  0  2  1  2  0  2
1  3  0  3  1  2  3  2  0  2  3  0  2  1  3  1  0  1  3  2  3  2  3  2  1  0  0  0
2  0  1  1  1  3  3  1  3  0  3  2  1  1  2  3  3  1  0  3  1  1  0  3  1  1  1  0
2 1 2 1 1 3 3 1 3 2 3 2 3 3 0 1 3 3 0 3 2 0 0 0 2 0 0 2
1 3 1 1 3 0 1 3 3 3 1 2 3 1 2 2 3 2 2 0 2 2 1 0 0 1 0 2
3 0 3 2 2 2 1 3 0 3 0 0 3 3 0 2 3 1 0 3 0 0 1 1 0 1 1 0
0 3 2 3 3 1 2 0 0 1 3 3 3 0 3 2 3 0 1 1 1 1 3 3 2 2 3 0
1133223213021220001131233110
2201101032131222231201010312
2  2  2  3  0  1  0  1  2  2  1  3  2  1  3  3  0  3  0  0  0  0  1  2  1  1  3  0
3303011232321032103022110110
1 1 3 2 0 0 3 3 0 1 3 3 1 1 3 2 1 1 0 1 1 2 2 0 2 0 1 2
3  2  2  3  1  2  0  2  2  3  0  1  0  3  2  0  2  1  3  2  2  1  3  2  1  3  1  0
3133213120330202210003020102
1123031023331031032032001010
0  3  2  2  1  0  2  3  1  3  0  0  0  1  0  2  3  3  0  0  3  1  1  0  2  0  2  0
3212302232302110332200232120
0110111010010010111011011110
