1 0 3 3 0 1 3 2 0 2 1 3 2 0 1 0 0 2 0 2 3 2
3000313020000030201010
0 3 3 3 1 0 2 3 1 1 3 2 1 0 3 0 0 0 0 3 1 0
0  1  3  3  1  1  2  2  3  3  1  2  3  0  1  3  0  0  3  3  0  2
3210002321121132213310
1  0  1  1  1  0  1  2  0  2  1  0  2  2  3  2  2  1  0  2  1  0
0221322320223033110330
3313220202121130200102
0  1  0  2  1  1  2  1  2  1  2  2  3  3  3  3  1  2  1  0  2  0
3 2 3 1 0 2 2 0 2 3 1 1 3 1 0 2 1 2 0 2 0 0
1 2 3 1 0 2 1 0 2 1 1 2 1 2 0 1 0 2 3 1 3 2
3  3  2  0  2  3  0  1  2  3  2  1  2  1  3  3  1  3  3  1  2  2
0 1 1 0 3 3 1 3 1 1 3 1 1 3 1 2 0 0 3 2 0 2
1 3 0 1 1 3 3 1 3 3 3 3 1 2 1 0 2 0 3 1 3 0
3  1  0  3  1  1  3  3  1  3  2  0  3  0  3  1  0  0  2  1  1  2
2131122102331102330312
3203013101200200323102
2  2  1  2  3  2  2  2  0  1  3  3  0  3  1  3  0  2  3  2  0  0
0  0  1  2  2  3  3  0  2  0  2  0  0  0  1  2  0  3  0  2  0  0
3301203021200023231030
3031113302321011011210
2  2  0  0  0  0  0  2  2  3  2  3  2  0  3  0  2  3  1  3  2  2
3220121302333230120020
3 3 0 2 3 2 2 3 3 0 1 0 2 3 3 0 0 0 0 1 1 0
3  2  3  1  2  1  2  0  3  3  3  0  1  3  0  3  2  3  1  2  0  0
0  0  1  3  3  2  1  1  1  1  3  3  2  1  2  3  2  2  2  3  2  2
1011313033131031331210
3 3 3 0 0 0 0 0 0 1 0 2 2 1 3 3 3 3 0 0 3 2
0 0 0 0 0 1 1 1 0 1 1 0 1 0 0 1 1 0 1 0 1 0
