3 2 1 3 1 0 3 3 0 2 3 0 2 1 3 0 2 1 0 2
0 0 2 0 3 2 0 1 1 2 0 2 2 2 1 2 0 3 2 0
1  0  1  3  0  1  2  3  2  3  1  0  1  2  1  0  0  1  3  2
3  0  2  3  1  2  1  1  2  3  2  1  0  3  0  2  3  2  2  2
1  2  2  1  2  0  2  1  2  3  3  0  1  3  3  0  2  1  2  0
2  3  1  0  1  1  2  0  3  3  2  2  0  1  1  3  3  2  0  0
02111011311012201100
00030222212023301200
1  2  3  0  0  1  2  3  3  2  0  0  3  2  0  0  2  2  3  0
1 0 1 2 1 2 3 1 3 1 3 2 1 3 0 0 1 2 1 0
0 1 1 2 3 3 2 0 1 2 3 1 3 1 3 0 1 0 1 2
0  2  2  3  0  3  1  0  0  0  0  3  2  0  1  0  3  0  2  2
0  1  0  0  3  0  1  3  2  0  3  2  1  2  1  1  1  3  1  2
0  0  0  1  1  1  2  3  3  3  2  2  3  2  0  3  1  1  1  0
2  2  2  3  2  2  3  3  3  1  2  0  2  0  1  1  3  2  1  0
22231322210021103022
1  3  2  2  1  0  1  1  2  3  0  0  1  2  2  0  1  3  2  2
3  0  0  0  1  2  2  3  2  2  1  1  0  2  3  0  3  2  0  2
20220311321012101010
03022232032102311000
0 3 1 0 1 2 0 2 2 0 3 1 1 3 0 2 1 0 1 2
2 2 1 3 1 3 3 1 2 1 2 0 1 1 3 2 1 2 3 2
02300230010130211032
22321310322111213030
0  2  1  3  3  2  2  0  0  3  0  2  0  0  0  1  0  0  1  0
13302003030111132212
3  1  1  2  2  3  1  2  1  3  3  1  3  3  1  3  1  1  3  0
11220212322313003210
3 1 2 2 1 0 3 3 2 1 1 1 3 1 2 2 0 0 2 2
1 0 0 1 0 0 0 1 0 0 1 1 1 1 0 1 0 1 1 0
