1  2  3  2  3  1  1  3  0  1  1  1  3  2  1  3  3  0  2
2113130310211022132
1  1  2  3  3  3  0  2  3  1  1  2  0  2  3  0  2  1  2
2 0 0 2 1 1 1 3 1 0 1 0 3 0 1 0 0 3 2
3  2  1  2  0  3  3  0  3  0  0  3  0  0  1  3  3  1  0
0  3  0  0  1  3  2  0  3  0  2  2  0  1  0  0  3  1  0
1101111321233032232
1321023111200212030
0  0  1  3  3  3  2  3  0  3  2  3  1  2  3  2  2  3  0
3232312003213331302
0323030112122000300
3 1 2 3 2 2 3 2 2 3 0 0 0 3 3 1 2 0 0
0202002011332022202
0100001101100011000
