2 3 1 1 0 2 1 2 0 1 2
1 3 3 2 2 2 3 3 0 1 2
3 1 1 1 1 0 0 0 0 0 0
00310212020
0  2  2  3  2  0  1  0  2  1  0
12233012202
1 1 2 2 3 3 1 2 0 2 0
02120100302
1 2 3 0 1 3 3 0 0 2 2
3 2 0 0 0 0 1 3 2 1 2
3  3  0  3  0  1  3  2  3  1  0
30121133030
3 2 2 0 2 1 3 2 1 3 2
2 2 0 0 2 0 1 2 1 2 0
12210322100
0  2  2  3  2  3  0  2  3  3  2
1 3 2 3 2 0 2 2 0 3 2
1  2  0  3  2  2  1  1  1  1  2
3 1 3 1 3 1 2 0 2 3 0
2  2  0  2  3  2  1  1  2  2  0
0 0 0 0 1 3 1 2 1 1 0
0  3  3  3  1  2  2  2  3  0  2
02112222112
20101230132
3 0 3 3 2 2 1 2 2 3 2
22031002230
23202321130
1  3  1  1  2  1  2  2  1  2  0
11032133320
1 1 1 0 1 0 1 1 0 0 0
