0 0 3 2 2 1 0 0 1 0 0 3 0 3 0 3 2 3 3 1 0 1 3 0 3 0
3 3 3 1 0 2 0 2 2 2 1 0 1 2 0 0 1 3 1 0 3 0 2 2 1 0
31213232312033311300031220
32333333232132133201223300
0 3 1 3 1 2 2 0 1 3 2 1 2 1 0 2 1 2 0 3 1 3 1 2 2 0
3  3  0  2  0  1  0  1  2  3  1  0  1  1  1  2  2  2  2  0  0  0  2  0  2  2
0 3 2 3 3 0 2 2 1 2 2 1 0 1 0 1 0 0 2 1 1 3 0 3 3 2
2 1 2 0 3 0 2 3 3 0 0 3 1 2 1 2 2 3 2 3 1 1 1 1 1 2
0 3 0 3 0 2 3 0 2 3 2 0 1 1 3 0 3 3 2 3 1 0 1 1 2 0
30013132203210331321031002
3 0 2 3 1 1 2 2 3 0 2 0 0 0 2 3 0 0 1 1 2 3 0 0 2 0
31120021032131202113201100
1  1  0  0  2  0  1  2  0  3  0  1  0  0  3  0  0  0  0  0  1  2  0  0  2  0
3 0 1 0 0 1 1 3 2 3 3 3 1 3 0 2 1 2 1 0 1 2 1 0 1 2
0  3  0  0  0  1  3  2  1  3  3  1  3  2  2  0  2  2  3  2  3  2  1  3  3  0
1  1  3  2  1  1  0  2  2  0  0  1  2  3  3  0  0  0  2  3  3  0  2  1  1  2
3  1  1  1  3  0  0  3  3  1  3  3  1  1  1  2  1  3  2  1  0  0  0  3  3  2
2  1  0  2  2  1  2  1  1  1  1  2  1  0  3  1  3  3  1  3  2  2  0  2  2  0
1 1 1 0 3 0 0 3 3 1 1 0 0 2 1 2 0 0 3 1 3 0 2 0 3 0
30022013102330012130121320
02013322211332002133211102
1  0  2  3  0  3  0  3  1  1  1  2  0  2  2  0  1  3  3  1  2  1  0  1  2  2
3 1 1 3 3 2 3 0 3 0 1 2 2 2 2 0 2 0 2 2 3 1 0 1 2 2
13313211031030302100313100
00210213112130312330013030
21313023123001133121232302
1 2 2 2 3 3 3 2 3 0 0 0 0 0 0 2 0 2 2 3 3 3 0 0 2 2
20020310022113300302121300
1 2 2 1 2 3 3 0 2 1 3 3 3 3 0 2 1 0 0 2 0 2 0 3 1 2
0  2  1  2  0  0  0  1  0  2  0  1  2  2  0  0  0  3  2  3  3  3  1  2  1  0
01010100001011101110110010
