2 1 2 3 2 1 0 2 3 0 1 3 1 1 3 1 0 0 0 2 0 1 0 2 2 1 1 3 0 2 2 2 2 3 2 2 2 1 1 0
2  1  3  3  2  3  2  1  2  0  1  1  2  1  0  3  1  2  2  2  2  0  3  3  2  0  1  2  1  3  0  0  1  0  2  1  1  0  1  2
3220030231103001103203210020010330030102
2200321220130323232021310201203321100312
0311121002313220133103103032223001002220
1 3 3 0 2 0 3 2 2 2 1 2 1 2 1 3 3 2 1 0 0 1 1 3 0 3 3 1 2 1 0 2 1 3 3 2 1 3 3 2
3322123132013030211030101132300320332300
1 2 3 2 0 0 3 3 2 3 2 0 0 3 1 0 0 3 3 3 1 2 0 3 3 3 0 1 0 2 1 2 0 2 1 2 0 3 1 2
0020222211302323122302211202302333012300
1  3  0  0  0  1  0  0  0  3  2  0  3  2  1  2  2  2  2  3  0  0  2  3  1  0  1  1  2  3  0  3  3  0  2  2  0  3  0  2
0  0  1  1  1  1  0  1  1  1  0  1  0  1  1  1  1  1  0  0  0  0  0  1  1  0  0  0  1  1  1  0  1  1  0  1  0  0  1  0
