3 0 2 2 2 3 3 3 2 3 1 2 3 2 3 0 2 2 3 0 1 1 2
2 0 3 1 2 3 3 3 0 2 2 3 3 0 0 1 0 3 1 2 2 1 0
33030122201213030311302
23031320021123113222102
31100030301321310302112
12202023311310330103010
1  3  2  2  3  2  2  1  0  3  2  1  2  3  2  2  2  1  2  0  0  0  0
31102303212322201021322
3 1 0 0 0 1 2 3 0 2 2 1 0 1 2 1 3 2 3 2 1 0 2
1  3  3  1  3  2  0  2  0  3  2  3  2  1  3  2  3  1  1  1  2  1  2
33111011200120232132000
1 3 1 0 0 0 0 0 0 3 1 0 1 1 3 0 2 0 0 0 1 0 0
00032131313310132022310
2 2 0 2 0 0 3 1 0 0 1 0 1 1 1 3 0 1 3 0 3 1 2
1 3 2 0 3 2 2 0 0 2 3 1 0 1 2 0 2 1 0 0 2 2 0
1  1  0  2  1  0  2  1  0  2  2  3  2  3  2  2  3  2  2  0  3  2  2
1 1 0 2 1 0 2 1 3 2 1 2 1 2 1 1 3 3 1 0 3 1 2
2  0  3  2  2  2  0  1  1  3  0  2  0  1  1  1  0  1  2  3  0  0  0
1  0  0  0  1  1  1  1  0  0  1  0  1  1  0  1  1  1  0  1  1  0  0
