11123012211202222100303210
32133232323110313201101000
3  0  1  3  0  3  1  1  0  3  2  1  0  1  1  0  1  2  1  2  1  1  2  2  3  2
01022333212102332022103010
0 1 3 0 0 2 2 3 2 1 0 0 3 0 0 1 2 2 2 1 3 2 3 2 3 0
00300030131112002322012322
23002112102220211010001010
0 3 2 0 0 0 3 3 2 0 3 2 1 2 2 2 1 2 2 2 0 0 2 1 2 2
21130123331110202112000302
3 3 3 0 2 3 1 3 1 3 1 3 3 1 1 0 0 3 2 3 3 2 2 2 0 2
22302131210321103200101110
3  1  0  0  2  1  1  3  2  2  2  0  0  3  2  2  2  3  3  0  0  3  2  0  1  2
1  3  2  0  0  1  3  2  3  0  0  3  3  2  2  0  0  2  2  3  0  0  2  1  2  2
2  2  1  0  3  3  1  3  1  2  2  2  2  1  1  2  2  2  1  0  0  2  1  0  1  2
2 2 1 0 3 2 2 2 0 2 0 2 2 2 0 3 0 0 3 0 2 1 2 3 1 2
2 0 3 2 2 0 0 0 3 1 2 1 1 1 1 1 2 3 2 1 0 1 2 1 0 2
0  1  2  0  3  0  0  3  0  2  2  0  2  2  1  2  1  3  1  0  1  2  2  1  0  0
1 1 2 1 2 3 2 1 1 1 1 0 2 0 1 2 0 3 0 3 0 0 0 2 0 0
33011021230310020333003232
21202002030031003212203132
0  3  2  0  3  0  3  1  2  3  0  1  2  2  2  0  3  3  1  3  1  0  0  0  0  0
0 0 3 2 2 2 3 3 2 1 1 1 2 1 0 1 1 1 0 1 3 3 0 1 0 2
20200333302022323010012002
21032332302120111101130310
22320333123013120110133230
1  0  3  2  2  2  2  0  0  0  0  0  3  2  1  3  3  2  2  3  2  1  1  1  2  2
0 0 0 0 0 0 1 1 0 1 1 1 1 0 1 1 0 0 0 0 1 0 0 1 0 0
