3120121020020100313132111010
2123111012003312112123022032
1  2  2  1  1  0  3  0  1  3  0  2  2  3  2  3  0  1  3  2  1  1  1  1  1  2  0  0
3  0  1  3  1  2  1  2  2  0  0  0  0  1  3  2  3  3  2  1  1  0  0  3  1  1  0  0
2030132011130120132210322010
2 2 2 2 2 1 2 2 0 1 3 0 3 3 1 1 1 0 2 1 3 2 3 0 3 3 1 0
2  0  0  3  1  1  0  2  3  2  0  1  0  3  3  3  2  0  0  0  2  0  3  2  2  1  3  0
3  0  0  0  2  2  0  3  3  3  1  0  2  2  1  0  1  3  2  1  2  1  2  2  0  0  2  0
3  3  2  3  3  2  1  1  3  1  1  0  2  1  3  2  0  3  2  2  3  1  1  0  2  1  0  0
2212011303120001030010210132
1131332231103223111033020302
3  0  0  2  2  2  3  1  0  1  0  0  1  1  3  1  2  0  0  2  0  0  1  1  2  3  1  0
2  2  0  1  2  3  3  3  3  2  1  1  3  0  2  1  2  3  1  3  3  3  0  3  0  0  2  2
3  0  3  3  3  0  2  1  3  1  1  1  3  0  0  2  3  1  2  3  1  2  0  3  0  1  2  0
1 3 2 2 0 3 1 0 2 2 3 2 3 3 2 1 0 2 3 0 0 0 0 2 0 3 3 0
3333313213213100113200212200
2213203232330303003113120132
0  0  0  1  0  1  1  0  0  0  1  1  0  0  0  0  1  0  1  0  0  1  0  0  1  1  0  0
