2 0 1 3 2 2
2 2 3 0 3 2
0  0  1  1  1  2
213222
3 3 3 2 1 0
2 1 3 3 3 0
0 3 2 2 3 2
1  1  1  0  1  0
1 1 0 1 2 0
021110
0 1 0 1 0 0
