1  0  3  2  1  3  2  0  2  0  3  1  3  1  3  1  0  1  3  3  2  1  2  3  3  3  2  0
0322021233312323122031230130
0 3 3 2 1 3 2 2 3 0 0 0 0 3 2 2 3 0 1 0 0 2 3 1 3 2 1 0
3230332300213030102030123112
2 2 1 3 2 2 0 2 3 2 2 3 1 1 3 2 0 0 1 3 1 0 0 2 0 2 0 0
0 1 1 0 2 3 1 1 0 0 0 2 1 2 3 3 0 0 3 1 0 0 2 1 2 2 3 0
3022300231100212022010100332
1  2  2  1  0  2  1  1  0  1  1  0  2  2  2  0  0  0  0  0  0  2  1  1  3  0  2  2
2033302130300202221313012020
2 0 3 3 2 1 2 2 0 0 1 1 1 3 0 0 0 0 0 0 0 0 1 3 0 1 0 2
2302211232122123333313320232
1  2  3  3  0  3  0  0  1  3  3  1  3  3  1  2  3  3  2  3  3  2  2  0  3  3  0  0
3 2 3 3 2 0 2 0 3 0 0 3 0 3 3 2 0 0 3 1 3 2 3 3 0 0 1 2
0 1 1 3 0 0 0 2 2 1 0 3 2 2 2 0 2 3 3 3 3 3 0 0 0 2 0 2
1  3  2  3  1  1  3  2  3  1  1  2  1  1  2  1  3  3  3  0  2  0  2  3  1  3  0  2
2  0  0  2  0  3  1  2  2  3  2  2  2  0  3  0  3  2  1  2  1  1  3  3  0  2  0  0
0110011000000100110101000110
