2  0  0  2  2  1  2  0  0  0  3  1  0  0  0  1  2  2  1  2  2  2  3  1  1  0
3 3 2 3 2 3 0 1 2 2 3 2 0 3 0 2 2 2 1 2 1 1 1 0 3 0
3  2  1  3  3  3  0  3  2  1  2  0  1  2  0  0  3  0  2  3  3  3  0  3  0  2
1  2  2  3  2  3  2  0  2  1  2  2  3  2  1  3  3  0  3  2  1  0  1  1  0  2
2  3  1  0  3  2  0  0  3  3  0  3  0  2  3  1  2  0  0  2  3  2  1  1  3  0
20303231203331100011110002
30232212132110222311222120
23221220131313120002313210
2  0  3  2  2  3  1  3  3  0  0  0  2  3  0  0  3  2  0  3  0  0  0  0  3  0
2  2  2  3  0  3  2  3  0  3  1  1  1  0  1  2  1  2  1  2  1  1  3  1  2  2
03113222303232212231221002
31230110221003002021221302
1 0 1 0 0 0 1 0 0 0 0 1 1 1 1 1 0 0 1 0 0 0 1 0 1 0
