3  3  0  3  3  0  1  3  0  2  2  2  0
3  1  0  0  2  2  1  2  1  0  1  1  0
0 3 2 0 0 1 3 2 2 3 3 1 2
1 2 0 3 0 2 2 1 3 0 2 0 2
1 2 0 0 3 3 0 2 2 2 0 0 2
1130102132220
0021322313000
2  1  0  3  1  3  0  2  0  0  0  1  2
2003302213300
1  2  0  2  0  0  2  1  3  0  2  2  0
3  3  1  3  1  1  0  2  1  1  0  3  2
1 2 0 1 1 3 2 1 0 0 1 1 2
3  2  3  2  1  2  1  0  2  0  0  1  2
3  1  1  3  3  1  1  0  0  1  2  0  2
1010010020302
1 0 0 2 0 1 3 0 0 1 0 2 0
0001033213302
3031221320320
3031301212012
1221113020122
0213131132320
1  1  0  2  0  0  3  1  0  3  3  3  2
2 2 0 2 1 2 1 1 3 0 2 0 0
2 2 0 3 0 2 2 1 2 0 1 2 2
1 3 3 3 3 3 2 2 3 2 1 3 0
0  1  3  2  0  3  1  1  0  2  1  1  2
2 1 2 1 0 0 3 3 1 1 3 1 0
3 2 3 1 2 0 0 1 0 2 2 0 2
2  2  1  3  3  3  3  0  3  2  2  0  0
2  3  0  2  3  3  2  3  0  2  1  0  0
0  1  0  1  1  0  0  0  0  1  1  0  0
