1  0  3  2  2  2  0  2  2  3  3  2  2  3  3  3  0
0 1 2 3 1 3 3 2 2 2 3 2 3 3 2 2 0
31213111021202022
22002301332021202
3  3  1  2  1  0  3  2  2  3  3  0  2  1  2  0  2
20023111113012032
1 2 0 0 2 0 3 2 1 3 0 0 0 1 1 2 2
3 3 1 0 0 1 1 3 3 1 0 1 1 3 0 1 2
10221022230300020
0  1  3  3  0  1  1  0  0  3  2  3  2  0  2  0  0
2  3  3  1  0  2  1  3  0  0  1  0  3  0  3  0  2
1 3 3 1 2 3 2 1 0 1 3 3 1 3 2 2 2
00121133113333310
13020333100211110
0 0 0 0 1 0 3 0 1 1 1 2 3 3 1 3 2
1 2 1 2 1 2 0 0 2 1 0 3 0 0 0 2 0
33033001320210010
33303100021231312
3 3 0 0 2 0 0 1 1 1 1 0 2 0 2 2 2
30312201121323322
0 1 3 3 3 3 0 3 2 1 2 3 2 0 1 0 2
2 2 0 3 1 2 3 2 1 2 1 0 1 0 1 3 2
2  0  2  2  0  2  2  1  3  3  0  1  0  2  0  2  0
0  3  3  3  2  3  0  2  3  3  2  3  3  2  3  0  2
1 0 1 0 3 1 0 3 2 2 1 2 2 1 0 1 2
1 0 3 0 3 3 2 3 0 1 3 3 2 1 2 0 2
3 1 2 0 0 0 2 2 3 2 1 2 2 2 1 0 0
2  0  1  0  0  3  1  1  2  1  3  3  0  1  3  1  0
1 1 1 1 1 1 1 1 0 0 1 1 1 0 0 0 0
