3  1  0  2  3  0  3  2  3  2  3  3  2  0  0  1  1  0  0  3  3  3  3  0  3  0  3  2  3  1  2  3  2  2  2  3  0
0211332223113012002311303303330233302
1 2 0 0 1 1 2 0 0 2 3 3 3 3 0 0 2 0 0 3 0 0 3 2 2 2 2 2 0 2 3 1 0 0 3 2 0
2 0 2 0 1 3 2 1 2 2 3 2 1 1 2 0 0 1 3 0 2 0 1 2 1 0 0 3 0 2 3 1 1 2 0 1 2
1 2 1 2 2 3 0 1 2 1 3 3 2 3 3 1 0 0 1 2 2 1 3 3 1 1 0 0 0 2 3 2 1 0 2 0 0
0  2  0  2  1  2  0  1  3  3  3  1  1  0  2  0  1  1  3  2  0  0  3  3  1  2  0  3  2  3  1  1  1  3  3  2  0
2112300313313100301232012331320121112
0021202100101223330203032112022021210
3 0 0 1 3 2 3 3 2 3 2 0 3 2 0 0 1 3 1 3 0 1 1 1 1 1 0 0 3 1 3 2 3 1 3 3 2
3 2 2 0 1 0 0 3 3 2 1 2 0 0 0 3 2 3 1 0 1 0 2 1 3 0 1 1 1 0 1 0 1 2 1 0 0
3111003200231120330230000102110321320
1133002322233231111133311332032012120
2 3 0 2 1 2 3 2 0 1 2 1 3 2 0 3 3 0 3 3 3 2 1 3 1 0 0 0 1 0 3 1 3 0 3 3 2
0 0 1 3 3 2 0 2 2 0 3 1 3 3 0 1 2 2 3 3 0 2 2 0 2 1 2 1 0 1 2 2 2 2 2 2 0
3  3  0  2  0  2  3  1  1  2  3  3  1  2  0  3  1  2  0  0  0  2  1  3  3  2  0  3  0  2  3  3  2  3  3  3  2
3  1  2  2  1  1  0  1  1  0  0  2  1  0  1  0  2  2  1  3  0  1  0  1  1  2  3  0  3  0  0  2  2  1  0  1  2
2  0  2  0  2  3  3  2  1  1  2  2  1  2  1  3  0  0  1  2  3  3  3  1  2  1  0  1  1  2  1  3  1  0  2  3  2
2122032131113200332233013122302123122
2  1  3  0  3  1  3  1  2  0  3  2  2  0  2  2  3  0  2  1  0  2  3  0  2  0  0  2  3  0  3  3  2  3  3  2  0
3301220133222001303003311223012330120
3 1 3 2 1 0 3 1 0 2 3 2 2 3 1 2 2 2 3 0 3 0 2 3 2 3 3 3 3 1 3 2 2 0 2 1 0
0131010221020101312310003130000120202
3 0 2 3 3 2 0 3 1 1 2 3 1 2 1 1 2 3 3 0 1 0 0 1 3 1 0 3 1 3 2 1 0 0 0 0 0
1100110011100101000000011000101110110
