1 0 3 3 3 3 3 0
23303110
1 0 3 1 3 0 2 2
10320130
1 2 3 2 1 3 3 0
3  1  2  2  2  1  1  2
33123310
32310000
2 2 2 2 2 3 1 2
0 1 0 2 3 2 1 0
1  0  3  0  0  2  3  0
1  3  1  0  0  3  3  0
03021310
21120022
13202010
2  0  2  3  1  1  1  0
23333010
0 1 1 1 0 1 1 0
