0 2 0 3 1 2 3 0 0 1 2 2 0 1 1 2
2  0  3  0  3  2  0  1  1  0  3  2  2  1  2  0
1 3 3 3 1 1 1 2 1 0 0 1 0 3 1 0
3323003330330030
1032230010023200
2  3  2  1  3  0  0  2  2  3  1  0  2  2  1  2
2 1 0 1 0 0 0 1 0 3 3 1 3 2 0 0
2  3  3  2  0  1  3  1  3  3  1  3  3  3  1  0
2 1 0 3 1 2 0 1 0 3 1 2 0 2 3 0
0  3  0  1  0  1  0  0  1  0  1  1  0  1  3  0
2 1 3 1 3 1 2 2 3 1 3 2 2 1 1 2
3201103030101010
1331310212123110
1 1 0 0 1 1 1 0 3 2 3 2 3 0 3 0
2  2  2  1  0  2  0  1  0  0  2  2  3  2  0  0
2 3 1 3 3 2 1 1 0 3 0 3 1 3 2 0
1  0  0  0  0  1  1  0  1  0  1  0  0  2  0  2
3 1 0 3 2 2 1 0 0 0 0 2 0 1 1 0
1 0 2 3 0 1 3 2 1 0 1 0 1 2 3 2
3  2  1  2  0  0  0  1  2  2  1  3  2  1  1  2
3 0 1 3 0 0 3 0 3 1 1 2 1 0 1 2
3 3 0 3 3 2 2 0 3 0 3 0 1 0 2 0
1  3  0  0  0  3  2  0  0  0  0  2  3  2  3  2
0  2  2  2  3  1  2  0  3  3  0  0  2  1  2  0
3  0  3  2  1  3  3  3  3  2  3  0  2  0  3  2
0311200111002302
0 1 1 1 1 1 0 0 0 1 0 0 0 0 0 0
