0  3  1  1  0  0  3  1  3  2  0  3  2  3  3  1  3  2  2
1  1  3  0  0  2  1  1  2  0  2  2  2  3  3  2  0  0  2
2  1  1  0  1  3  1  0  0  2  2  2  3  3  2  3  3  2  0
0230010032112102120
1  3  1  1  3  3  1  2  1  2  3  2  3  1  1  1  2  0  0
1222100020020320222
3 3 3 0 0 0 2 3 0 2 1 3 2 2 0 0 0 2 0
0 0 2 1 3 1 1 3 3 2 0 0 0 0 3 3 2 0 2
0 1 1 0 1 0 1 1 3 3 1 3 0 1 2 3 1 2 0
1310012032313122312
0201331111312300200
2333111332122110010
0 1 0 2 0 3 3 1 2 1 2 2 1 1 1 0 2 3 2
2 3 3 3 1 3 1 1 3 3 0 0 2 1 1 2 0 3 0
1211203013021122210
0323013301033330130
0300212310232332120
1 0 2 3 2 2 3 0 3 1 0 2 0 2 1 0 0 2 2
1 1 1 3 3 1 2 0 1 0 3 2 1 0 2 3 0 0 0
2221313303021131010
0 0 1 1 0 1 2 2 2 1 3 0 2 3 1 1 2 1 2
3220023122122312130
1 1 1 1 2 0 1 2 2 3 2 3 0 2 3 3 3 2 0
0213322011211312120
0000000111011110100
