1 3 1 3 3 1 1 1 2 2 3 0
2 3 0 2 2 3 0 2 2 2 3 2
3  3  3  2  3  0  2  1  0  3  0  2
031000122120
0  1  3  3  2  1  3  1  3  3  1  0
113102220112
2 3 2 3 2 1 3 0 1 3 1 2
1  0  1  0  1  0  0  0  0  1  1  0
