32003310032203121222213220
3 3 3 0 0 0 0 3 1 2 0 3 3 1 1 3 0 2 2 2 3 0 0 1 2 0
00011302021200313003311000
01200111320220023130331110
1  1  1  3  1  1  3  2  3  3  3  1  2  1  3  2  0  3  2  0  3  1  0  0  2  2
0  1  3  2  2  0  1  1  2  0  0  0  2  1  1  0  3  3  3  2  3  0  3  1  0  0
2  3  3  2  0  2  1  2  0  0  0  3  0  2  0  1  0  2  2  0  2  3  2  0  3  2
21222112321300310022011002
1 0 1 1 1 1 2 0 0 0 3 2 0 2 0 1 3 1 2 3 0 3 1 2 1 0
02221203212021110102222032
13100211030102100302013122
3 2 1 2 0 1 2 1 0 0 1 3 1 3 2 2 3 3 2 2 2 2 2 3 0 0
1  0  2  1  0  3  0  2  3  2  1  0  0  3  3  0  2  0  1  3  1  2  3  1  1  2
2 0 2 0 3 2 1 3 0 3 0 2 3 0 3 1 3 2 1 2 0 1 0 1 1 0
2 3 1 2 3 3 0 2 2 3 3 1 2 2 0 3 0 1 0 0 3 0 3 1 0 0
0  0  3  3  1  2  2  2  1  3  0  3  1  1  2  2  2  3  2  0  3  1  2  2  2  0
3  2  3  0  2  0  0  3  1  2  1  2  0  0  0  2  1  3  1  3  2  1  2  3  0  0
2 1 3 0 3 0 1 0 0 2 0 1 2 3 1 1 3 3 2 0 1 2 0 3 1 2
2 2 3 3 3 2 0 2 2 2 2 0 3 2 2 1 0 0 3 1 1 2 2 3 0 0
0 1 0 0 0 1 1 1 1 1 2 1 3 3 0 1 2 2 2 0 2 2 1 2 1 2
3  2  1  1  0  2  2  0  0  2  3  2  0  2  0  1  0  1  3  3  2  2  0  1  2  2
3 1 1 0 0 2 3 1 1 0 2 1 1 3 1 1 3 1 3 1 1 2 0 3 3 0
3 3 1 1 0 0 1 3 0 3 3 0 2 0 1 3 1 1 1 1 0 2 1 1 1 0
1  0  1  3  0  3  3  3  0  3  0  0  1  2  1  1  0  1  1  3  1  3  1  2  3  0
0  2  1  3  0  0  0  1  2  2  0  3  0  3  1  1  0  2  2  2  2  1  1  3  3  2
3 0 0 2 3 0 2 1 1 2 0 2 2 1 0 3 0 0 2 0 1 0 2 0 2 2
33203221320111213203032330
1 0 0 0 1 0 0 1 1 1 0 1 1 0 0 0 0 0 0 0 1 1 0 1 1 0
