0 0 2 2 1 2 0 0 0 3 3 0 0 0 1 3 3 1 1 3 2 3 3 2
023012322321023223110332
3  0  2  3  0  3  1  2  1  1  1  0  1  1  3  3  0  0  3  3  2  1  1  0
0 3 3 3 3 3 3 0 3 0 2 3 3 2 3 3 3 0 0 1 1 2 3 0
0 0 1 3 1 2 0 1 1 0 1 1 3 2 3 3 0 3 1 2 2 2 0 2
020132001302201222113112
010132310320232302023222
1  2  0  1  3  1  0  3  0  3  1  2  1  2  2  2  1  0  3  2  1  0  0  2
0 1 3 1 3 0 1 0 0 0 1 2 2 0 0 0 3 3 3 2 3 3 2 2
003233311020231331020102
0  2  1  1  1  1  1  3  3  0  3  3  0  3  3  2  1  3  0  1  3  0  3  0
2  1  1  2  2  3  1  0  1  2  0  2  0  0  3  2  3  0  0  0  3  3  0  0
3 1 0 2 2 2 3 0 3 2 0 1 1 3 3 2 3 1 0 3 2 0 3 0
313300200131003031013000
011123320113221120002102
0  2  1  1  3  3  1  2  2  2  3  2  3  1  3  0  0  2  0  3  2  1  3  0
0 3 3 2 0 3 3 1 2 1 1 0 3 0 2 1 3 1 1 1 1 2 2 0
1 0 1 2 0 3 1 3 0 3 2 0 1 2 3 1 1 2 3 1 0 3 0 0
2  2  3  1  3  3  0  0  2  2  2  1  0  2  1  1  0  1  0  2  1  0  2  0
0  3  3  1  2  0  3  0  1  0  0  2  3  2  1  1  2  0  1  0  1  0  0  2
2 0 1 1 0 3 2 1 3 1 1 0 1 0 2 0 1 2 1 1 3 3 2 0
3 0 3 3 3 2 1 2 2 1 0 0 2 0 3 2 1 0 2 0 0 1 1 0
1 3 2 1 0 0 2 0 2 1 2 3 3 0 2 2 3 0 1 1 2 2 3 2
102030031200112212002300
110110011010111000010100
