0  1  2  3  2  2  0  3  3  2  0  0  3  0  3  2  3  0  1  2
1  3  3  3  1  0  1  3  0  1  0  1  1  0  0  2  0  3  2  2
0 3 2 3 2 1 2 1 2 2 2 0 0 1 1 0 2 2 3 2
21131121022311303102
0 1 2 0 2 1 1 2 1 2 3 2 3 1 2 3 1 2 1 0
21132213310021332232
3  3  0  3  2  0  1  0  1  2  1  3  0  2  2  0  2  0  2  0
0 3 2 1 3 1 2 1 1 3 2 3 3 0 0 0 3 0 0 0
3 0 3 2 3 1 0 3 3 1 2 0 3 3 1 1 1 2 3 2
2  0  2  0  3  0  2  3  3  3  2  2  3  3  1  1  3  2  2  2
1 1 3 1 1 0 2 0 0 2 2 2 3 0 1 3 1 2 1 0
1 1 2 1 3 3 2 3 0 1 1 0 2 2 2 2 0 2 2 0
10303033031200232120
1 1 0 3 1 3 0 1 3 1 3 0 2 3 2 2 2 0 3 0
23031312100213322220
3 3 2 1 0 1 0 1 1 1 0 1 3 2 1 3 2 3 0 0
2  2  2  2  2  0  2  2  1  1  3  2  2  2  2  2  2  0  2  2
2  1  1  0  3  1  3  0  0  3  0  2  1  3  0  1  2  1  3  0
23230210302311202030
3  2  3  0  0  2  3  2  3  1  2  2  2  2  2  0  1  1  0  2
01100130122311100022
1  0  3  1  2  2  2  2  1  1  1  0  2  0  0  2  2  1  0  0
2  0  0  3  3  1  1  3  0  2  0  3  2  3  3  1  3  3  3  2
0  0  0  1  3  3  2  3  1  2  2  3  0  1  1  2  1  1  1  2
30200000330020321012
03033022222312023100
10001111001100011010
