2 0 2 0 1 2 0 3 0 2 2
2  2  1  2  3  0  0  2  2  2  0
3 1 2 3 3 3 1 2 3 1 2
1 0 0 1 3 0 2 0 2 3 0
32322023000
3 2 0 1 1 0 0 3 0 0 0
3 3 2 3 3 0 0 1 0 2 0
1  2  3  0  3  1  0  2  1  0  0
0  3  3  0  0  1  1  2  1  0  2
0 2 1 1 2 3 2 1 2 3 0
22000022012
32321031102
3  2  2  2  2  3  1  3  0  1  2
11120012300
0 1 2 2 3 2 1 3 2 2 0
2 3 2 1 0 0 1 1 1 3 0
3 2 0 2 3 3 1 3 2 1 0
13332322322
02002122010
10111312320
0  1  0  0  2  0  3  3  3  0  2
33220021120
32310033002
3  1  1  2  1  2  3  2  3  2  2
12223223300
00001000110
