3 0 2 3 3 2 2 1 1 2
1 2 2 0 1 1 3 0 1 0
3  2  1  0  0  1  2  3  1  2
2 1 3 3 3 2 1 1 0 0
0  3  3  1  3  2  2  2  1  0
2 2 2 3 3 0 1 3 2 2
0 0 1 0 2 0 3 0 2 0
3  1  3  1  2  2  1  2  3  2
2 0 3 1 2 2 0 0 0 2
2 2 2 0 0 1 1 3 0 2
1  3  0  1  3  3  2  0  3  2
3101102230
2031021000
0203301022
0  0  2  3  0  2  0  1  3  0
1  2  1  1  0  3  1  2  3  2
1 2 2 0 1 0 0 2 3 2
0  1  0  0  3  0  1  3  2  0
1233131020
1110331110
3302023030
0  0  1  2  1  3  3  1  1  0
1 0 0 1 3 0 2 1 3 2
2 0 2 0 3 0 0 0 3 2
2 2 1 0 3 1 1 2 1 2
0130332000
2  1  0  2  2  0  3  2  3  0
1  3  2  3  2  2  3  3  2  0
0313132212
0001111000
