2  1  0  2  0  0  1  0  0  0  3  2  0  3  0  0  1  2  3  2
11223032032220220320
2  1  3  3  0  2  2  1  0  1  3  3  1  2  2  3  1  2  3  2
3  2  2  1  0  2  2  1  1  3  3  2  1  2  3  0  1  2  1  2
3 3 3 0 1 0 2 1 0 1 1 2 3 3 2 2 3 3 1 2
0 2 2 2 1 1 1 2 2 3 3 1 1 3 0 0 1 2 3 2
12202012223223133332
1 1 2 2 1 0 2 2 1 2 3 2 1 2 0 1 1 3 0 0
20003201133022203330
1 3 2 1 3 1 3 1 0 0 1 3 3 3 1 1 3 3 1 2
1 2 0 2 1 0 3 0 3 2 1 2 3 3 3 3 3 1 3 0
12121222002132102330
32033022231000320300
3  3  0  0  3  0  2  2  1  2  3  0  2  0  2  2  1  2  3  0
0  0  3  1  0  0  2  1  1  3  0  2  2  3  0  2  3  1  1  2
13321323232332300222
03333220302111122200
3  2  1  1  3  2  3  3  0  1  2  1  2  1  1  1  1  0  3  0
31033222012330132002
1 1 3 1 1 1 1 3 3 1 1 0 0 3 3 0 0 2 0 0
21211113233020310122
0  1  0  3  2  3  0  3  2  2  0  3  0  1  3  2  2  2  2  0
30200300032332202000
31023003333100103322
22031120002020021032
0 2 3 0 0 3 3 3 3 2 0 2 1 2 0 3 2 0 2 2
1  3  1  0  0  1  2  0  3  1  2  0  3  2  2  2  1  2  1  2
23333002221021022302
0 3 0 1 3 2 3 0 2 1 0 1 2 3 2 0 3 3 3 0
00000001101001001100
