331133203103210303020
1  1  1  2  3  1  3  3  1  0  1  1  1  2  3  3  1  3  2  3  2
3 2 1 0 2 2 3 0 0 0 0 3 0 1 1 2 1 0 0 2 2
113010220010221103220
233132030310301102120
0 0 1 0 0 3 2 1 3 0 2 2 2 0 2 1 0 0 0 3 0
001131011011330113110
331322332100000111222
1  0  3  1  0  0  3  0  1  1  3  0  0  2  2  2  0  1  3  0  2
0  0  2  3  0  2  2  2  1  2  0  3  3  1  2  2  1  2  1  2  0
0 1 3 1 0 2 1 2 2 0 2 3 0 3 3 2 1 1 2 1 2
1  1  2  0  0  1  0  3  1  0  1  0  0  2  1  3  3  1  3  3  2
2  3  1  3  3  3  1  3  2  3  2  2  0  2  1  3  1  1  0  2  0
2 0 1 1 1 2 0 3 0 1 2 1 3 2 0 3 0 3 3 2 2
2 1 2 1 1 3 1 0 1 3 1 0 3 0 2 0 3 2 3 2 0
020301033031102303002
0  2  1  3  0  2  1  0  1  2  2  2  1  1  0  0  3  3  3  1  0
020202030303010103102
2  0  0  0  3  1  3  0  3  2  1  3  3  3  2  0  0  1  2  1  0
3 3 2 0 3 2 2 1 0 2 2 0 3 2 1 3 3 1 3 2 0
1  3  0  2  1  2  2  2  2  0  3  0  3  2  2  3  3  2  2  0  0
3  2  0  3  0  1  1  0  2  1  3  3  0  0  2  3  1  3  2  2  2
102202031010223101132
203003102311233232302
1 0 3 1 3 2 3 3 0 1 0 2 1 0 2 2 3 2 3 3 2
121233012212023013100
221111133120012211230
2  2  3  2  2  1  1  2  0  2  0  1  0  3  3  0  1  2  3  2  2
111100001010001010010
