2  0  0  2  0  3  2  3  3  1  1  1  2  1  1  1  2  3  3  2  1  0  3  3  3  2  3  2  1  0
1 2 2 3 3 0 0 1 3 3 1 0 0 3 2 0 0 0 0 1 0 0 2 2 3 2 2 1 1 2
3 3 1 0 2 3 2 2 1 1 2 1 2 0 0 2 0 1 0 1 3 1 0 1 2 1 1 3 0 2
0 0 2 0 1 1 1 3 1 1 0 0 2 3 1 1 0 2 3 3 2 2 3 3 1 2 1 0 3 0
2 2 0 2 0 0 3 2 3 1 1 0 0 3 0 1 3 2 3 2 0 3 0 2 0 2 2 2 0 0
2  0  1  2  0  3  3  3  0  3  2  1  2  2  2  1  2  1  0  0  0  1  1  1  3  3  1  2  3  0
130010221200201031033121003130
3  0  3  1  0  1  0  2  3  3  1  2  2  2  3  0  3  1  1  0  0  2  0  3  2  1  1  0  1  2
120203103123013300013102201032
031311231131031210123301101130
0  0  2  3  3  0  3  1  3  3  2  3  2  0  3  1  3  3  3  0  2  3  3  0  2  2  2  1  1  0
002023233103220220001100030300
003001222011122211332032223102
0  1  0  1  3  1  0  0  1  2  1  3  3  3  3  1  2  0  2  1  3  0  1  2  0  0  0  2  3  0
210102331213330002131110100102
1 2 2 0 0 1 3 1 1 3 1 3 1 1 3 2 3 2 1 0 1 0 2 2 2 3 2 1 0 2
2 1 0 1 3 2 1 2 3 0 0 3 0 1 1 1 0 2 1 0 0 3 3 0 1 1 0 2 3 0
2 0 3 0 3 3 3 2 1 2 0 1 2 3 3 3 1 2 3 0 0 3 1 0 3 3 3 3 3 2
3 2 2 2 1 1 1 2 3 0 3 2 3 0 2 1 1 3 2 0 3 3 0 0 2 0 0 2 1 0
0  3  2  3  2  2  1  2  1  0  3  1  3  2  0  3  2  1  1  3  2  2  0  3  2  3  0  0  1  0
2 3 2 2 3 3 0 2 0 1 3 0 3 0 1 1 0 0 0 3 2 3 1 0 2 1 0 1 2 2
0  2  0  0  3  0  1  3  2  2  2  1  3  0  0  1  0  0  2  2  0  0  0  0  1  3  0  0  0  2
203231022233233103333323323020
1 1 1 0 3 3 1 3 1 1 2 0 0 3 3 1 3 3 0 3 3 0 3 2 3 0 0 0 0 2
2  0  3  1  2  3  0  0  1  0  1  3  2  2  3  0  1  2  0  0  2  2  1  1  3  3  1  0  1  2
0  0  1  0  1  1  1  0  0  0  0  1  1  1  0  1  1  0  0  1  0  0  1  1  1  0  1  1  0  0
