3 2 2 1 2 2 3 2 1 0 3 3 2 1 2 1 0 2 2 0 3 0 3 0
1 0 3 0 2 2 3 3 0 1 0 2 2 2 3 3 2 2 2 3 1 2 1 0
320101333231321203223210
033332133032323120221320
3 3 1 1 3 2 1 1 1 2 2 3 1 0 2 3 3 1 1 2 2 2 1 2
2  0  1  3  1  0  2  2  1  3  2  0  1  1  2  2  3  1  2  0  1  2  0  0
221210110011003313111212
3 2 1 3 1 1 0 3 1 0 0 3 1 2 1 3 3 1 2 3 2 0 3 0
3  3  0  2  1  2  2  2  0  1  1  0  0  1  0  1  3  1  0  3  0  3  2  2
020320303310323330321120
031032012013221300213030
2  3  0  3  2  1  0  3  3  2  0  1  3  0  3  2  3  2  2  1  3  1  3  2
000101331211330321023132
0 0 1 1 0 0 0 1 1 0 0 0 0 1 0 0 1 1 0 0 0 0 1 0
