2  2  0  3  0  0  2  1  0  2  0  1  2  1  2  3  2  3  0  0  2  3  3  2  3  3  3  3  1  3  1  0  1  0  0
0 2 0 3 0 0 3 3 1 3 3 1 0 2 2 1 2 3 1 2 1 1 1 2 1 2 3 3 3 3 3 2 3 1 0
0 3 3 0 1 2 0 0 1 1 0 2 0 2 2 0 0 0 1 1 1 0 3 0 3 3 3 2 3 3 2 0 1 0 0
1  2  2  1  0  1  3  1  2  0  2  1  3  1  0  0  2  1  1  0  2  0  2  2  2  1  2  3  0  3  1  3  0  3  0
2  3  1  3  3  2  1  3  3  2  3  2  2  1  3  2  1  1  2  3  1  3  3  0  1  0  3  0  0  0  2  1  0  3  0
1 2 3 0 0 1 1 0 2 2 3 1 1 0 2 1 0 3 3 2 3 0 1 2 3 0 1 3 2 3 0 2 1 3 2
1 0 2 1 1 1 2 0 2 0 1 0 0 0 2 2 2 0 0 3 0 0 2 2 1 0 3 2 1 0 3 1 2 3 2
0  1  1  3  0  0  0  1  3  1  0  2  0  3  1  3  3  3  3  3  3  1  3  2  0  3  2  0  1  1  1  2  2  2  2
12210333031231210323233002303333000
0 1 3 1 2 3 2 2 1 2 1 2 0 2 1 3 2 1 1 0 2 1 0 0 0 1 0 3 0 2 0 1 3 2 2
3 1 1 2 2 2 3 0 2 0 0 1 2 3 1 1 2 2 3 3 2 2 3 2 0 1 1 2 3 1 0 0 2 3 2
3  3  1  1  0  1  3  1  0  0  0  3  0  0  3  2  2  0  2  0  0  1  1  0  0  3  3  3  3  0  1  0  3  1  2
0 0 1 1 0 0 2 2 0 2 3 3 3 3 1 1 3 2 3 2 2 3 3 2 0 3 0 3 3 1 1 3 0 2 2
3  1  1  2  0  0  3  2  0  2  3  3  2  1  1  1  0  3  2  1  0  1  3  3  0  3  1  3  2  2  1  0  2  3  0
0 2 2 1 2 0 0 1 0 1 0 2 2 3 3 0 0 0 1 1 0 1 1 2 3 2 0 1 3 1 0 2 2 3 0
1 2 0 2 2 0 3 0 1 2 1 0 0 0 3 0 2 1 3 1 1 0 0 1 1 0 0 3 2 0 0 1 1 1 0
10020211031320021210102223211230002
03012013310103310230312011033221120
1  1  2  1  0  3  3  1  3  1  2  1  1  2  2  2  0  2  2  1  1  2  1  3  1  1  2  2  0  1  2  0  0  3  0
31213230311331030113000323320102330
2 0 3 3 0 1 0 0 0 1 1 2 3 3 1 2 1 2 3 3 3 1 0 2 0 2 3 1 3 3 2 0 2 0 0
3  3  1  3  3  0  3  3  0  1  1  1  2  2  0  3  1  2  1  0  2  0  0  0  1  3  0  3  3  1  1  2  0  2  0
2  3  1  1  3  3  0  0  2  3  2  1  3  1  0  0  0  0  2  0  2  3  3  1  0  1  1  0  3  3  0  1  1  1  0
0  1  1  1  2  0  3  2  3  3  0  3  0  1  1  3  1  0  3  2  2  0  1  3  0  0  2  3  1  2  2  3  2  2  0
13221032232332312301022313220113010
0 1 1 1 3 0 2 2 3 3 3 0 1 2 3 1 3 3 3 1 1 0 3 1 1 3 1 3 3 1 0 3 3 2 2
10012300033130320113311321232002022
10132220103031200200311211110030100
01101010110111010001010110001000110
