1  1  3  3  3  3  1  2  1  3  3  2  1  0  0  1  1  1  3  3  3  1  1  3  1  3  1  3  1  3  2  0  3  3  2
3  1  0  2  0  0  3  3  0  2  1  2  2  3  1  3  3  1  0  0  3  0  1  1  0  3  2  0  1  3  1  3  0  1  2
0  0  3  1  1  3  1  2  2  0  3  0  2  3  2  1  1  3  0  0  3  0  1  1  0  2  3  0  1  3  3  1  1  0  2
0 1 3 0 2 3 3 2 0 0 1 2 1 2 3 2 0 3 3 1 2 3 2 2 2 2 0 0 3 3 1 2 0 1 0
2 1 0 2 3 3 3 0 1 3 3 3 0 3 3 0 0 1 1 1 3 0 0 0 0 1 3 0 0 3 3 1 3 1 2
3 3 0 3 1 2 1 1 1 1 3 0 0 1 0 3 3 2 3 2 3 3 2 1 2 2 2 0 1 3 1 0 2 2 0
1 2 1 1 3 0 2 0 2 3 3 2 1 3 1 3 3 1 2 2 1 3 0 0 3 1 3 3 2 3 0 2 0 3 0
10332121030310213331032330111001200
3 2 1 3 0 3 2 1 0 1 0 0 1 2 1 3 3 3 1 1 1 3 2 1 2 3 1 1 3 3 2 3 0 3 0
2  2  3  0  1  1  2  0  1  3  3  1  0  3  2  2  3  3  0  3  3  0  3  1  0  0  3  3  2  3  3  2  2  0  0
20000002120213100031100121110211322
2 1 2 2 1 1 0 1 2 0 2 1 2 1 1 3 3 0 0 1 0 1 2 0 0 3 1 1 2 1 0 1 2 1 0
12222033310012220222231011021213302
01332022122032002231211300211110030
21202223013313202330313112302131300
30222322322032303221103312131313332
0 3 3 2 1 1 1 2 3 3 3 0 3 0 1 3 3 3 2 0 1 2 3 2 1 1 0 1 3 2 2 1 0 3 0
2  1  1  2  1  2  1  0  1  2  0  1  2  2  2  2  3  2  2  0  0  3  1  1  2  0  0  3  3  1  1  1  2  2  2
23010212120230313203120332302132120
2 1 3 2 3 0 2 1 3 3 3 0 3 2 0 2 0 0 1 1 1 3 0 3 0 1 1 0 2 3 0 2 2 1 2
2  0  0  3  0  3  3  0  2  0  1  0  1  1  0  3  0  2  1  2  1  1  3  2  1  3  0  0  0  3  1  0  3  3  2
1 2 1 3 3 2 3 1 2 1 2 2 1 2 3 0 1 1 0 0 0 0 1 2 2 0 1 1 1 2 3 0 2 1 0
00101011000011100100101011100110100
