2  0  1  1  1  0  1  3  1  3  1  2  2  3  0  1  2  0  3  1  1  1  1  2  3  3  2  0  3  0  1  2  2
321311312203122023021121210123032
0  1  2  2  2  2  2  1  3  3  2  1  2  1  0  0  3  2  2  3  2  3  2  1  2  1  2  0  1  2  3  3  2
1 2 1 0 3 0 3 0 1 2 2 2 2 0 2 2 0 3 0 1 2 3 0 1 0 1 0 0 2 1 1 1 2
001033033121032321321030313301120
0  2  1  1  3  2  1  0  0  1  1  3  3  1  2  1  3  1  3  2  0  0  1  0  2  0  1  2  0  2  2  3  2
131110001312212231333202210332130
1  0  3  3  3  3  1  0  2  1  1  1  0  3  0  0  0  1  1  2  0  2  0  1  0  0  1  3  1  3  3  2  0
2  2  1  0  3  2  1  0  2  3  1  1  0  0  0  1  3  3  0  3  2  3  1  1  0  1  3  1  3  2  2  0  0
3  0  2  2  0  3  2  0  1  1  0  3  3  2  0  2  0  2  3  1  3  0  3  0  3  3  1  0  0  2  2  1  0
3  1  3  2  2  3  2  2  1  2  2  3  3  0  3  0  0  3  2  3  1  2  0  2  0  0  2  3  1  0  0  1  2
101223103220213312231332102213312
1 0 0 1 0 0 3 3 2 2 1 1 1 1 3 0 0 2 3 2 2 1 1 2 0 3 0 2 1 1 3 2 0
3 2 1 2 0 1 2 0 3 2 3 2 2 0 0 2 1 2 2 2 0 3 0 0 1 3 0 0 3 2 1 1 0
0  3  1  1  2  2  2  0  3  0  1  0  1  3  3  2  0  2  1  2  0  3  1  2  0  3  1  2  0  3  2  0  2
310011201130010101202013020133210
2 0 0 0 3 1 1 1 0 2 0 3 0 2 3 1 3 3 1 0 3 2 2 2 2 0 1 3 3 2 2 0 0
0  0  0  2  1  3  3  3  2  1  0  0  2  0  0  0  1  1  1  0  2  3  1  0  2  3  2  2  2  0  3  1  2
021332120103113011122313231102012
100101101001111101100101010101000
