2 2 1 1 3 3 2 2 2 1 2 1 1 0 3 3 3 1 3 2 2 0 0 2 0
2 3 2 0 1 0 2 2 0 0 0 3 1 2 0 2 0 2 3 1 0 1 2 0 0
0102321300323023002132200
2  1  3  2  1  1  0  1  2  1  1  0  3  2  0  3  3  0  1  0  0  0  2  0  2
2  1  3  3  1  1  1  2  1  3  0  2  3  0  3  1  0  2  1  2  3  2  2  1  0
0002212233200011313023230
0313010310312130032331122
1 1 1 0 1 1 0 1 0 1 1 0 0 1 1 0 1 0 0 1 1 0 0 1 0
