1 2 3 0 2 0 3 1 2 3 1 2 3 1 2 1 1 2 0 0 3 2 1 2 1 3 2 1 0 1 2 2
11223200210020220322231232002102
32103033310311110310232331002210
03122231033122222202001331001122
0  1  0  0  1  1  1  1  3  1  1  3  0  1  1  1  3  1  1  2  0  0  3  0  1  0  0  1  0  2  0  2
0 0 0 1 2 3 2 0 0 3 1 0 1 2 0 2 3 0 1 0 1 3 2 0 2 1 1 3 2 3 3 0
2  0  0  3  3  1  3  3  3  2  2  1  1  2  3  3  1  2  1  3  1  1  1  2  1  2  2  0  2  0  2  0
03300122103120122100012313232232
0  1  2  3  1  1  3  2  3  2  3  1  2  3  2  3  3  1  1  1  2  1  0  2  2  1  3  0  2  3  2  0
1  2  0  3  1  2  1  3  2  2  1  3  1  3  3  1  3  3  0  1  3  1  1  1  3  1  3  3  0  0  1  2
1  3  1  0  0  1  0  2  0  1  2  0  3  3  2  0  2  0  0  1  3  1  1  1  3  3  1  0  0  3  2  2
1  0  0  0  1  1  1  0  0  0  1  0  1  0  0  1  0  0  1  1  0  1  0  0  0  0  0  0  1  1  0  0
