2  0  1  3  0  1  0  3  2  2  0  0
1 2 1 2 0 2 3 3 0 1 2 0
1 2 1 3 0 0 1 2 1 1 0 0
032110030002
011120012110
2  1  2  0  3  3  0  3  2  3  0  0
0 0 1 0 1 1 1 0 1 0 0 0
