1022012123000132011121130121100030120
3  1  2  1  0  2  3  3  1  2  3  1  2  0  0  1  1  1  2  1  2  1  1  3  0  0  0  0  1  2  1  0  3  1  3  0  0
2332310003323021220000002200122303230
1  2  0  3  2  0  2  2  3  0  3  3  0  0  2  3  2  3  2  1  2  1  0  2  3  3  1  0  3  0  1  1  1  3  3  0  2
0201122212102230313131111300123313130
1013100322030130331230013322330300130
1 3 3 3 2 2 2 3 3 2 3 3 1 3 0 2 0 3 0 2 2 1 0 0 0 1 0 3 0 0 2 0 0 2 2 2 2
1312330230120133120131030312123202130
0323111102222001001310201221332202102
2 2 2 1 0 2 2 1 3 1 2 1 0 0 3 2 2 3 2 3 3 1 2 2 0 1 0 2 3 1 3 1 3 2 2 0 2
0 2 1 3 2 1 1 3 3 3 3 3 3 2 3 1 2 1 3 0 1 2 0 0 3 2 0 2 1 1 1 2 2 2 2 1 0
2  0  2  1  0  1  2  0  0  0  1  2  1  2  0  2  2  0  1  2  1  1  1  0  3  2  1  1  1  1  2  1  0  1  3  0  0
2 3 2 0 1 3 3 0 3 2 2 0 3 3 0 1 1 0 1 2 3 3 0 3 2 2 0 3 3 3 1 1 3 2 1 0 2
3102311130300111220200322001311313122
1  1  0  0  0  3  2  2  0  1  0  3  2  3  3  1  1  3  0  0  2  2  1  2  1  3  2  1  2  3  0  0  0  0  2  0  0
0  0  3  1  2  1  0  0  1  3  0  0  3  3  0  3  0  0  1  1  0  2  2  1  1  3  1  1  2  3  1  1  1  2  3  3  2
0  0  1  2  1  3  0  2  0  0  0  1  2  1  3  3  2  3  2  3  2  0  2  2  3  2  2  2  1  2  3  0  2  2  2  1  2
3  0  1  3  1  2  2  0  2  1  3  0  2  3  3  0  1  1  1  2  3  0  0  0  2  0  3  2  2  3  2  1  0  2  1  2  2
1  3  0  2  2  2  3  1  3  1  2  1  0  1  3  3  1  2  1  2  1  3  1  1  2  0  0  2  0  2  3  3  2  3  1  2  2
3  0  2  3  0  2  1  0  2  0  3  0  3  2  3  2  2  0  2  0  0  3  0  2  0  3  2  0  3  1  2  1  3  1  0  3  0
2230333112123023302122301310011201232
2210031013100121003133022302210000212
1  2  3  1  2  2  0  0  0  0  0  1  3  3  1  3  0  2  2  1  3  3  2  1  0  3  0  2  2  3  0  3  3  0  0  0  2
1  2  3  2  1  3  3  1  1  1  1  3  2  1  3  2  1  1  0  0  1  2  0  2  0  0  2  0  3  3  3  0  2  0  1  0  2
2  2  3  3  2  3  2  1  3  0  1  1  2  3  2  2  2  1  0  0  1  2  0  0  3  1  0  0  2  0  1  3  3  3  3  1  0
1313311200230122123321222320121212112
1033012323320101223321112121020022202
1 1 3 0 3 0 0 0 3 0 1 0 3 0 0 1 0 1 1 0 2 2 0 1 3 2 1 1 1 1 0 2 3 1 0 0 2
3121031220223022303033330103202303100
2 2 3 1 1 1 0 3 0 3 2 3 2 0 3 2 0 3 2 3 0 2 1 1 3 3 3 0 2 1 2 2 2 3 2 1 0
1 0 1 0 1 0 0 0 0 1 1 0 1 1 1 0 0 1 0 1 1 0 0 1 1 0 0 1 0 1 1 1 0 0 1 0 0
