2 0 2 1 0 1 0 0 2 1 2 3 3 2 2 2 1 0 0 3 2 0 3 3 0
2 0 3 2 3 1 2 3 0 2 2 2 2 3 2 0 2 1 3 0 0 3 1 2 0
1 1 2 0 2 0 0 2 3 0 1 0 2 1 1 0 1 2 3 1 0 3 0 1 2
3132312200333132303330130
1  2  2  1  3  2  1  3  0  3  2  3  0  2  3  2  0  2  0  0  0  2  0  2  0
0  1  0  1  2  1  1  0  2  1  3  1  3  3  0  1  1  2  1  0  2  3  0  3  2
1211100012021022010311000
3 1 3 3 1 2 1 3 1 1 3 0 1 0 1 0 3 2 0 0 0 2 0 0 0
2 0 3 1 0 1 0 2 0 3 2 0 0 1 1 0 0 1 1 1 2 3 0 2 2
0 3 2 2 1 1 1 0 2 2 0 1 1 1 3 0 0 3 1 0 0 1 1 1 2
3 1 3 1 2 1 3 1 1 0 0 1 2 2 3 1 3 0 3 1 2 1 3 0 2
3 1 3 1 1 2 2 0 0 2 2 1 0 0 0 3 0 0 2 1 2 2 0 1 2
3 1 3 2 1 1 3 3 1 1 2 3 3 2 0 0 3 0 0 0 0 1 2 0 2
2 2 3 2 1 1 0 1 3 2 2 2 0 2 2 2 1 1 3 3 3 1 3 0 0
3313102333102222100120310
1 1 2 3 2 1 2 2 3 0 3 2 3 1 3 1 3 0 2 1 2 1 2 0 0
1 0 1 2 3 2 3 1 2 3 1 1 1 1 0 0 3 0 0 0 0 0 2 3 0
1212010320301023010230130
1333102132230010023120020
0201103221213223102220020
2100300112030203023233222
2010130232001321023311300
0  1  3  3  1  1  2  1  0  1  2  2  0  2  2  3  1  3  3  3  0  1  1  3  0
1221201212212211102210332
0  1  1  1  0  1  1  1  1  1  1  0  0  1  1  0  0  0  0  0  1  0  0  0  0
