0 1 0 0 0 2 0 1 1 1 1 2 1 3 2 3 1 0 1 1 3 2 3 3 3 2 3 1 0 2 1 0 3 1 0 3 2 1 0
3 1 3 0 3 3 2 3 3 2 0 2 3 1 0 3 0 3 0 0 3 2 1 3 0 2 2 0 1 1 2 3 3 1 1 3 1 1 0
1  1  2  3  0  1  0  3  0  0  1  2  0  0  3  0  1  0  0  3  3  2  0  0  0  0  0  0  2  0  0  1  2  3  3  1  3  2  0
3  2  1  3  0  2  3  2  1  0  1  0  2  0  3  2  3  1  0  3  3  2  1  3  1  3  3  0  2  1  0  2  3  3  3  2  2  2  0
0  3  1  2  1  0  2  0  0  1  2  0  3  2  3  0  2  3  2  1  3  2  1  3  3  1  2  3  3  2  1  2  2  0  1  2  1  1  0
323013233230222212123022123022221102002
302203331120212220332123213303112322030
032122110011222333233011012102130230012
3 0 1 1 0 1 0 2 0 3 1 1 2 1 3 2 3 0 2 3 2 0 3 1 0 1 3 0 1 1 2 0 1 0 3 0 0 3 0
3 1 1 2 0 1 2 3 1 1 3 2 3 2 3 1 1 0 0 0 1 2 0 2 3 3 0 1 0 2 0 3 3 3 1 1 0 1 0
2 3 1 0 2 2 1 0 1 3 0 2 2 0 1 1 2 0 3 0 2 2 3 3 2 0 3 2 0 2 2 2 3 3 0 0 0 1 0
3 1 3 3 0 2 0 3 0 3 1 3 3 3 0 2 1 3 0 2 3 1 3 0 1 2 3 0 3 1 1 1 1 1 3 3 3 0 0
0  2  0  0  0  1  2  3  2  2  3  0  2  3  3  2  2  3  0  0  0  1  3  2  3  1  0  1  0  0  3  2  0  0  3  3  3  0  0
122323303323123320110020311332112313020
201213331100011030032223222110320323210
1 1 1 1 0 2 2 1 3 3 3 1 3 1 1 1 3 1 3 2 0 3 2 3 0 2 1 0 1 3 2 3 0 2 2 2 1 1 2
000000110011011000101001111110001001010
