1  2  3  1  3  1  1  3  2  0  1  0  1  0  1  0  0  2  2  2
3  0  0  0  0  2  1  2  0  1  0  2  0  3  1  2  0  1  3  2
11232111001201203222
0 0 2 1 3 3 1 0 2 0 3 2 0 1 0 2 0 2 1 0
03133122100023323322
13322110212130100130
0  0  3  3  2  2  2  1  3  3  1  1  0  3  2  0  3  2  0  2
0  2  0  3  0  2  2  0  3  0  0  3  2  0  2  1  2  0  1  0
1 0 2 3 0 1 3 2 3 3 2 3 3 2 0 2 2 0 0 0
32210322200021210132
32113230022212303210
0  1  0  1  3  0  0  3  0  3  0  2  2  3  3  2  2  0  0  2
33233232210120101000
02233223020101320020
1  3  1  0  3  2  0  3  3  1  2  1  1  3  3  0  3  1  0  0
3  2  1  2  3  3  0  2  2  0  2  2  2  0  3  0  2  0  2  2
1 0 0 0 0 2 2 3 3 0 0 2 0 2 1 1 2 2 3 0
12312103022121130230
0  0  0  0  0  1  1  1  0  1  0  0  1  1  1  1  0  1  1  0
