3 1 1 2 0 3 2 2 1 1 1 1 2 0 0
221132030113320
3 3 1 1 2 1 1 1 1 1 2 1 1 0 0
210031222002100
0  2  2  3  3  0  0  0  0  2  3  0  1  0  2
3 0 1 2 3 2 0 1 2 1 2 0 0 3 0
202121022220110
1 2 1 3 0 3 3 2 0 0 2 3 2 1 2
331032330303310
2  0  3  0  2  3  2  1  1  3  1  2  3  2  2
331131310012012
310131310331122
002013011220122
320321223011330
302030122103122
332220301010212
2  2  1  0  2  2  1  0  1  1  1  1  2  1  2
113001010023022
2 3 0 2 0 0 0 3 1 2 3 3 1 3 0
1  0  3  2  2  0  0  0  1  0  0  0  0  0  0
3 1 1 3 0 3 2 3 3 0 3 0 3 2 2
3 3 1 1 2 3 3 0 3 0 1 3 3 2 0
113123210120130
0  0  0  3  0  1  1  0  1  0  3  1  2  2  0
111011100001100
