0  0  1  3  0  2  0  0  1  1  3  1  0  1  0  3  1  3  1  3  2  2  1  3  3  2
3 3 3 0 3 2 1 1 3 0 1 1 1 0 0 1 2 2 0 1 1 1 1 2 1 2
10001003132022121120300122
03131321111012310332212200
0  2  2  1  1  2  0  0  1  1  0  3  2  3  0  1  3  2  1  2  3  1  3  0  3  2
2  3  0  2  3  0  0  2  3  0  3  1  1  1  3  1  2  0  0  0  1  0  3  3  1  2
11230133023120321101210300
2  2  2  0  1  1  1  2  1  2  1  3  1  3  0  0  3  0  0  2  3  0  2  0  1  0
01102313332230211320221300
1  2  0  3  0  0  1  1  3  2  2  0  3  3  0  1  1  3  2  1  1  2  3  0  2  0
30220131131332220231230222
3  0  0  3  2  2  1  0  0  2  1  3  1  2  3  2  1  2  2  3  1  3  2  3  3  0
01112302232320202110203230
33211001220121002332100200
03333202312003010120010310
0  1  2  3  3  1  1  1  1  3  1  2  3  0  1  1  3  0  3  2  2  2  3  3  0  0
03303012323321322023220110
1 2 2 1 3 1 2 3 0 3 1 2 2 3 3 0 0 1 3 0 1 3 1 1 2 2
21233202303322231331233032
13303012101302001221132012
02020122112002010001232332
01300022121122322300120002
31301033300122213321220100
3 1 2 3 3 0 1 2 2 1 1 1 1 3 0 1 0 3 3 3 3 0 2 2 2 0
00121033002220233010201010
3 2 0 2 2 0 0 2 1 3 2 2 2 1 3 1 3 3 2 1 3 1 0 3 3 0
0 2 3 0 3 3 1 3 2 1 2 2 1 0 3 2 2 2 2 1 1 1 1 3 3 0
0 0 3 2 1 1 0 3 0 0 3 3 2 0 2 2 3 1 1 1 3 3 0 2 0 0
2  0  3  1  2  3  3  2  0  2  1  0  0  3  0  0  0  0  1  0  2  3  3  3  2  2
0 1 1 1 0 1 0 1 0 0 0 0 1 1 0 1 0 0 1 1 1 0 0 0 0 0
