0 3 3 0 0 1 0 3 3 0 3 1 3 1 1 2 2 2 0 3 1 1 0 3 1 0
1  2  1  1  2  1  3  3  2  2  0  2  0  0  2  1  1  2  0  2  0  2  2  3  2  0
3  2  2  2  3  1  1  3  1  2  1  0  3  0  0  2  1  0  1  2  1  3  1  2  0  0
2  2  0  0  2  2  2  0  1  0  3  3  1  0  1  2  3  0  1  1  2  0  1  1  1  2
2 0 3 2 2 1 0 0 0 0 2 1 1 1 3 1 2 3 1 0 2 3 1 1 2 2
0 3 3 3 1 3 0 3 2 2 3 0 2 2 1 3 2 3 3 3 0 2 3 2 1 2
11001010322102132132221232
3 0 1 2 0 3 2 1 3 0 3 0 1 2 2 1 3 1 1 2 0 3 0 2 2 2
3  3  3  3  3  0  3  3  2  0  0  3  3  1  0  0  1  2  1  0  3  3  1  1  3  0
2  1  1  2  1  1  0  3  3  1  2  1  3  1  3  3  2  1  0  0  3  3  2  1  0  2
33233200022102301122000000
12003220133303302032103330
2 1 2 3 3 0 0 0 2 1 3 3 2 2 0 2 0 1 0 3 2 2 2 1 3 0
32220233020023223233213030
3  1  3  3  2  0  3  1  2  1  1  2  1  2  3  1  3  2  3  2  0  0  2  0  1  0
31210300311232210320003202
0 0 2 2 1 0 1 0 1 0 0 2 3 0 1 1 2 0 2 2 1 2 0 3 0 2
1  2  1  2  1  3  1  0  1  1  2  3  1  1  1  0  1  2  1  0  1  2  1  2  3  2
1 0 3 0 1 1 0 0 3 3 1 0 0 2 3 0 1 0 1 1 0 2 3 3 0 0
22311303220230310032213302
2  0  2  1  2  3  3  1  0  2  0  0  1  0  0  2  3  2  1  1  1  0  2  1  1  0
30212002001011022231300122
3  1  3  3  2  0  1  2  0  3  2  1  3  0  0  3  1  3  3  1  3  3  0  3  0  2
01010101000010100010011000
