3  2  1  1  3  2  0  0  0  0  3  1  0  0  3  0  2  3  2  3  1  0  3  0  2  2  2
1  2  1  3  2  0  2  2  2  0  2  3  2  2  3  0  0  1  0  2  3  1  0  0  1  2  0
330002113022322313102302002
201113320103330120321132130
1 1 2 0 2 0 1 3 0 2 1 2 0 1 0 1 0 2 3 1 1 0 1 2 2 2 0
203002012000032311032300012
1 0 1 1 1 2 3 1 3 2 0 0 3 1 1 3 3 3 0 3 1 0 0 3 0 3 2
1 2 0 3 0 3 3 1 3 1 2 1 3 1 3 3 2 2 0 0 0 3 3 3 0 0 2
023110021103020333022201230
000000103232211023030130100
2  3  2  3  3  3  3  2  1  1  3  3  3  0  3  1  3  2  0  0  1  1  2  1  1  0  2
2 1 1 3 3 2 0 1 0 2 3 1 1 1 2 0 2 1 1 3 1 1 2 2 1 3 2
3 1 3 0 3 3 0 3 0 2 0 2 3 1 2 3 1 3 3 2 0 2 3 2 1 3 2
2  2  1  3  2  2  1  3  2  2  2  0  2  3  1  3  0  3  1  0  2  0  1  0  3  3  0
2  1  1  0  1  1  1  0  0  0  3  2  3  1  3  2  2  2  0  2  0  3  1  2  2  2  2
2 0 1 1 3 1 2 3 3 3 1 2 0 1 2 2 3 3 0 3 3 1 1 1 1 1 0
030210222322033123201131032
2 0 0 1 0 0 2 3 0 0 3 2 3 3 1 1 0 3 1 3 0 1 2 2 0 3 2
112320033301010001221001310
3 0 1 3 0 3 1 1 3 3 3 1 1 3 1 2 0 0 0 0 0 0 0 0 2 2 0
2 3 0 2 0 1 1 3 1 2 3 1 3 2 1 0 3 3 3 0 2 3 3 2 1 3 2
2  2  1  2  2  2  1  0  2  2  3  3  3  0  3  1  2  0  3  3  2  1  1  2  2  0  2
1  0  3  1  1  1  2  2  2  2  2  3  3  1  3  0  1  1  3  2  1  0  0  1  0  0  0
0 2 1 3 3 0 0 3 2 3 1 0 2 1 1 3 3 0 3 3 1 0 2 1 2 2 0
232022103002013231102100202
1 1 1 0 0 1 1 1 0 1 1 1 1 0 0 1 0 0 1 1 1 1 1 0 1 1 0
