1131210303212210103322222322300111022
0  1  1  0  1  3  1  0  2  2  0  0  3  0  2  2  0  3  0  2  2  3  3  1  0  3  1  2  0  3  3  1  3  3  0  2  2
3  1  1  2  0  0  2  3  2  2  0  1  1  3  3  3  0  3  3  1  3  1  2  0  0  0  1  2  2  0  3  2  1  2  3  0  0
2 3 0 1 0 3 1 3 1 2 2 2 2 1 1 0 3 2 3 2 0 2 3 3 0 1 1 1 2 1 3 2 3 0 2 1 0
2 3 3 3 3 0 0 3 2 3 2 2 1 3 1 0 1 2 2 2 1 0 2 2 0 0 0 3 1 2 2 3 1 2 2 1 0
3  0  1  3  2  0  2  0  3  0  0  1  2  2  3  2  0  3  1  0  2  2  3  1  1  2  2  0  1  2  1  0  1  0  3  3  0
0230210303122113101223122212202003310
0210221113203303023310232301333300000
3311312020120102101002312201223220000
1  0  3  3  2  0  1  1  0  1  0  0  0  3  2  3  3  1  2  2  0  1  0  3  1  0  3  2  1  1  3  1  1  0  2  0  2
1  3  0  2  1  1  2  3  1  1  1  0  3  1  2  0  3  2  0  0  1  1  0  1  2  0  2  3  3  1  1  0  3  3  3  2  0
1023032032112121203301120112111020032
0  2  1  2  3  0  3  2  3  2  0  1  0  2  3  3  0  0  1  1  0  1  1  3  1  0  0  3  0  1  3  2  1  2  1  0  0
1 1 1 3 0 1 3 1 3 3 1 3 2 1 1 3 2 3 2 0 2 0 0 3 3 3 3 1 2 1 2 2 0 3 2 3 2
0  3  0  2  0  2  3  0  3  0  0  1  0  3  0  0  2  0  1  0  0  2  3  2  1  0  3  1  3  1  1  3  2  0  1  2  0
0 1 0 0 0 0 0 0 1 0 0 1 0 1 1 1 1 0 1 1 1 0 1 0 1 1 0 0 1 1 1 1 1 1 0 0 0
