23313320
02303220
0 0 0 0 3 0 3 2
01201112
23012110
2 3 3 1 3 3 1 0
3 2 2 3 0 3 1 0
0 0 0 1 1 2 3 0
1  2  1  0  0  1  2  2
01000332
3 2 2 3 1 2 1 0
02023122
2 3 3 3 1 2 2 0
32023020
2 3 3 2 2 1 1 0
0 2 2 3 3 1 0 0
0  0  0  0  0  1  0  0
