3  3  1  0  1  3  0  2  0  1  2  0  3  3  2  1  3  1  0
2  0  2  1  0  0  1  1  0  0  2  2  1  2  2  1  0  1  2
3 3 2 0 2 2 1 3 0 1 2 2 0 0 0 2 3 0 0
2  1  3  2  1  1  2  0  1  3  0  3  3  0  3  3  1  2  2
3210333303013210312
2023033003120002110
3 2 0 3 3 0 2 3 0 1 1 2 1 3 0 0 1 3 2
0 1 2 3 1 3 0 1 0 1 3 3 0 2 0 3 0 1 0
1123312333130223330
2 3 1 2 2 2 3 0 0 3 1 1 2 0 3 2 3 3 2
2  2  0  0  0  1  1  3  1  2  2  2  0  3  1  2  2  0  0
0  3  0  2  3  2  0  3  2  0  3  3  0  0  1  0  3  1  2
3333320123030212112
1 0 1 2 2 3 1 3 2 1 0 0 1 3 2 0 2 2 2
3 3 2 1 2 0 0 2 2 1 2 3 0 1 0 3 0 2 2
1  1  2  1  0  1  0  1  2  0  1  0  3  0  0  2  1  0  0
3  2  0  0  3  1  2  2  1  1  2  2  0  1  1  0  1  0  2
1121103203003211030
2 3 3 3 1 3 3 0 3 3 2 1 2 2 3 1 0 2 2
2  0  2  2  1  2  1  3  1  1  3  1  0  0  0  2  2  1  0
2 2 1 3 1 3 1 1 2 3 2 1 1 2 3 2 1 0 2
3  1  0  3  2  0  2  3  0  0  2  0  3  1  3  1  1  1  2
3 0 0 0 3 0 3 0 2 2 1 2 1 0 2 3 3 1 2
2 2 1 1 3 3 1 2 2 1 1 1 0 1 3 3 2 1 0
2212133103323131302
0020320020022012010
0  0  2  1  0  0  2  2  2  2  0  0  3  2  1  2  3  0  0
1011011010111110100
