2  1  3  2  3  1  2  2  1  2  3  2  3  1  3  2
2013011023220122
0 0 0 1 3 3 1 2 2 0 1 3 2 1 3 0
0  0  0  3  2  1  0  3  1  1  0  0  2  2  3  0
0 0 0 0 2 2 2 1 1 3 0 1 3 0 3 2
1312033220130132
2212112131131210
3102320213310300
1031100313320132
0 2 1 1 1 3 1 2 2 3 3 2 3 1 1 0
1300332103131000
3  3  2  2  2  0  1  2  0  0  3  0  0  0  2  0
1231311302300330
2 1 2 3 0 2 0 0 2 3 0 1 2 3 1 0
0  0  0  3  3  2  1  3  2  1  1  0  2  3  2  2
1 2 1 2 1 0 1 3 1 2 3 1 1 3 3 2
0010011001111110
