1 0 1 0 3 2 2 2 3 1 0 1 0 0 1 2 1 2 0
1130203122213202100
1 2 3 3 3 0 2 3 3 0 3 2 0 1 3 3 3 1 2
2000302103011103020
3 3 2 1 3 3 2 3 3 3 3 1 1 3 3 1 0 2 0
0002200013123033022
0 3 1 0 0 3 0 0 1 0 1 1 2 1 1 1 1 1 2
3301231210311300122
3021200113321002110
2  1  1  2  2  2  1  3  3  0  3  0  0  0  1  2  0  1  0
0 1 1 2 0 0 0 0 1 1 0 1 1 1 2 2 2 1 2
3 3 1 0 1 1 3 2 2 0 1 3 0 2 3 2 0 3 2
2  1  3  1  3  0  1  0  1  1  2  2  3  1  1  3  1  3  0
1011023101201301112
1 3 1 2 3 3 0 2 2 3 0 0 2 0 2 3 2 1 0
0203220102120030310
1 1 3 3 2 1 3 3 2 2 2 2 3 1 2 1 1 3 0
1200131321200021222
3  2  2  0  0  2  2  0  3  0  3  0  1  2  2  0  3  2  2
3  2  3  3  0  3  1  1  1  3  3  3  1  0  1  0  2  1  2
0 1 1 1 0 1 0 1 0 3 2 1 3 0 0 1 2 2 2
3  3  2  0  1  1  1  1  3  0  0  1  0  3  2  0  0  2  0
1 3 3 2 0 0 3 0 1 2 3 3 0 0 1 1 0 1 0
2311002321200001322
2  1  3  0  3  3  2  1  2  0  2  0  0  1  0  0  1  0  0
0  0  1  1  1  0  2  1  3  0  0  0  2  0  0  3  2  3  0
0  1  2  1  2  2  2  3  3  0  2  2  2  2  2  2  0  1  0
2 1 3 1 3 2 3 0 2 0 0 0 3 3 0 1 0 3 2
1  0  0  0  1  0  1  1  1  0  0  1  1  0  1  0  0  0  0
