0021303203221110212
0  3  3  1  0  1  1  1  3  1  2  2  2  2  3  0  0  3  0
3130312101102122232
1 1 2 0 1 0 3 0 3 0 3 2 0 0 3 0 3 2 0
2  1  0  2  0  3  2  0  3  2  1  3  0  3  0  2  2  2  2
3210301121230322110
1322033111233323312
3  0  0  3  3  2  0  2  3  1  0  3  0  2  2  3  2  0  2
3 1 2 1 3 2 0 0 0 1 0 3 2 3 2 3 0 2 0
3002320131233323032
0 0 2 1 3 1 2 3 2 1 2 3 2 3 0 2 2 1 0
2  0  0  2  2  1  3  1  0  0  1  1  3  2  3  3  0  1  2
3032020302330302000
1112312203033102030
0  0  0  1  1  0  1  1  3  0  1  1  0  3  0  2  1  1  2
0 2 0 0 3 1 3 1 1 2 3 2 1 2 2 0 1 1 2
3  2  1  2  2  3  2  0  1  1  2  0  1  0  2  2  0  0  2
0  1  1  3  1  0  3  0  0  0  3  0  0  1  2  2  2  0  0
2033213120133330202
2 0 3 2 1 0 3 2 1 2 2 3 3 0 0 1 2 3 0
0033032332023111310
2 2 2 0 1 3 2 0 3 3 3 1 0 2 0 2 0 0 2
0331110233300100232
1 1 3 3 1 2 3 2 3 3 0 2 1 0 0 3 1 0 2
1003321033103213110
2 1 2 0 3 3 1 0 1 1 1 2 1 1 0 1 3 1 2
3 0 0 3 0 1 1 1 2 2 0 2 1 1 3 3 3 3 0
3102223300103212332
3 3 2 3 3 3 0 3 3 3 0 0 0 0 3 1 2 0 0
2330221320303331302
0 1 0 0 1 1 1 0 0 0 1 0 0 0 1 1 0 1 0
