0  1  1  3  2  1  3  3  2  2  1  2  1  3  3  0  3  2  0  2  2  0  0  0  1  0
23002120120221010222121330
3 1 1 1 0 2 1 1 0 3 3 2 1 1 2 1 0 1 1 2 2 3 1 3 1 0
2 1 2 0 0 0 3 1 1 2 2 1 0 2 2 0 3 3 0 1 0 1 1 3 1 2
1 0 1 0 3 1 2 3 1 3 2 0 2 3 3 3 3 1 3 0 0 2 3 2 2 0
1 0 1 1 1 3 3 1 0 3 2 1 2 1 1 0 1 3 0 3 2 3 3 2 0 0
3  1  2  0  0  2  0  2  1  3  0  1  3  1  3  1  2  3  3  2  3  2  3  0  3  0
2  3  3  3  1  3  2  3  3  2  2  3  0  2  1  1  3  3  2  3  2  2  2  1  0  0
0 2 1 1 0 2 1 2 2 0 1 2 2 1 2 1 0 0 1 1 1 3 3 1 0 2
11120013210211210323003032
0  1  0  1  0  2  3  0  1  1  0  0  1  3  3  3  3  3  1  0  1  2  0  3  3  0
10222233023203113320120122
0  0  2  0  0  0  2  2  0  1  3  1  2  0  3  2  2  2  0  3  0  3  1  1  0  0
20202103221122123300200230
11130221013020321120223020
2  3  3  2  3  0  3  1  0  0  1  0  3  1  1  0  0  1  1  2  3  2  0  0  1  0
2  0  2  1  3  0  3  1  0  0  2  0  0  3  2  1  1  0  2  3  2  1  0  0  0  0
0 0 3 3 0 0 2 2 3 0 2 0 2 3 2 3 1 2 2 1 2 0 3 1 3 0
3  1  0  0  3  1  1  3  0  3  1  1  2  2  3  0  3  3  0  2  0  0  3  3  3  0
00132321202112132330320112
10320033123112300022113112
3 2 3 1 2 1 0 3 3 1 2 1 1 0 1 2 2 2 0 2 2 1 0 3 2 2
1  0  0  3  3  2  1  1  2  3  3  3  3  1  1  2  3  2  0  0  1  1  0  0  2  2
22000222023322303102320120
32321202001302311200033212
0  2  3  1  0  3  2  0  3  0  3  0  1  2  3  1  1  3  2  2  3  1  3  1  0  0
10001101110000000011001010
