33231233000102023032120333102
1 3 0 0 1 2 2 1 3 0 0 2 3 3 1 3 1 1 2 3 2 3 2 3 0 3 0 0 0
0 1 1 1 1 3 1 1 1 1 1 3 0 1 1 0 1 3 2 0 2 3 0 1 2 2 3 1 0
10212023031101110232001301120
21211102133232223122020320310
2 2 3 0 2 1 0 2 2 3 2 2 1 3 2 3 2 3 3 0 1 0 2 1 1 1 0 2 0
0  2  2  1  3  2  3  2  0  3  1  0  0  3  3  1  2  0  3  0  3  3  2  2  2  0  2  2  2
2 3 2 2 0 1 0 3 0 2 1 0 2 3 3 3 2 1 1 1 0 0 0 1 0 0 3 1 0
22031310130312323211222023330
1 1 3 3 3 2 3 3 3 1 0 3 2 3 1 1 3 0 0 0 3 0 1 3 0 3 0 1 2
1 3 0 1 1 1 1 2 0 1 3 2 1 2 1 1 1 2 3 1 1 2 0 1 0 2 2 3 2
0 1 1 0 3 1 2 0 0 2 0 1 2 3 2 3 3 3 1 1 0 0 1 2 0 2 3 1 2
1 0 3 0 1 3 0 2 0 0 0 0 3 1 3 1 3 3 3 3 1 3 2 2 0 2 0 2 0
3 1 1 1 1 2 2 2 3 2 1 3 1 3 2 2 3 0 1 3 0 1 2 3 1 1 1 1 0
11203202222101033221321311122
1 0 3 2 3 3 1 2 3 1 2 2 2 3 1 2 1 1 3 2 2 3 1 0 2 3 0 1 2
23001331303230013020313013210
3 3 2 3 0 2 2 0 0 0 1 0 0 3 2 2 0 3 2 0 1 3 0 3 0 1 2 1 0
10022101131202321033122033022
3 0 2 0 1 3 2 1 0 0 2 3 3 1 3 3 2 3 0 1 3 3 1 0 2 3 3 3 0
1  0  1  2  3  0  3  3  1  1  2  0  2  1  2  3  2  0  2  1  3  2  1  1  0  0  0  0  0
3 1 2 1 0 2 1 3 3 2 0 3 2 0 2 0 1 3 3 0 2 2 2 2 0 1 3 2 2
03102202010100230120212212332
2 3 2 0 0 3 2 2 2 0 3 2 3 2 2 2 3 1 0 3 0 3 3 0 1 0 3 3 2
2 3 2 1 1 2 3 3 3 2 3 2 2 0 0 1 2 3 1 0 3 3 3 2 3 3 1 3 0
1 0 1 3 2 2 1 0 0 2 0 3 0 2 1 2 0 2 1 2 0 0 2 3 1 1 1 2 2
20200012100301302100312232320
3  1  3  1  0  2  0  1  1  3  0  2  2  3  2  0  1  0  1  3  0  1  2  0  2  1  2  0  0
2  0  2  1  2  3  3  3  2  0  0  2  0  0  3  1  0  2  3  2  1  2  2  1  2  0  1  3  0
33230321023013223110231330022
0 1 1 1 1 0 0 0 0 1 1 1 1 0 1 0 1 0 0 1 1 0 1 0 1 1 0 0 0
