0  3  1  0  1  3  0  0  0  3  1  2  3  3  2  2  1  3  3  2  0  3  2  3  0  1  2  2  2
3  1  1  3  3  3  1  3  0  1  0  3  0  3  3  0  2  0  3  1  0  1  2  3  2  2  1  2  2
31231332100212011113233110000
2 2 2 0 0 0 0 2 1 0 1 0 3 3 0 0 1 3 1 0 2 0 3 2 1 2 2 3 0
1 3 0 0 2 2 2 2 2 3 0 2 3 3 2 3 1 3 1 0 1 2 3 0 3 1 1 3 2
0  1  3  0  3  2  0  2  0  1  1  2  2  2  1  3  3  2  1  3  3  2  2  3  2  1  0  2  2
1  2  1  2  1  3  2  1  3  2  1  0  0  1  0  3  0  0  2  3  1  3  3  0  2  3  1  2  0
2  1  0  0  0  1  0  2  1  0  0  3  2  1  2  1  0  1  3  2  2  1  0  3  1  2  1  3  2
30001002223210311110000131132
01130200230332221333210300320
1 0 2 2 0 1 0 3 3 1 1 3 0 1 2 0 1 0 3 2 3 0 0 2 2 0 3 2 0
0  3  1  2  0  3  0  3  0  0  0  3  2  2  2  1  3  3  3  2  2  2  0  1  1  3  0  0  2
0  1  0  3  1  1  0  1  1  0  3  2  1  1  0  2  2  2  2  3  3  1  3  0  1  2  2  3  2
12311211023003310320121201020
0  0  0  2  1  1  1  2  1  0  1  3  3  1  3  0  1  1  1  0  1  1  1  0  0  2  3  2  2
0 0 1 0 0 1 1 0 0 1 0 1 1 1 1 1 0 0 1 0 0 0 1 0 1 0 1 0 0
