3  2  2  0  3  1  1  2  2  1  2  3  2  2  1  1  0  0  2  2  2  3  2
2  3  3  1  1  0  3  3  3  1  1  1  1  0  0  3  0  0  2  0  2  3  0
1 2 2 0 1 3 0 2 1 3 3 2 0 3 0 0 3 0 2 1 1 0 2
0  3  2  0  2  3  3  3  0  3  2  0  3  2  0  2  0  3  0  2  3  2  0
31103023120102203112022
1 0 0 2 2 2 0 2 0 1 0 3 1 2 1 3 1 1 0 2 3 3 0
13023233303322003312210
1 2 0 2 3 2 3 3 3 2 1 0 3 2 0 1 2 3 3 0 1 1 2
0  1  1  2  0  0  3  3  3  0  3  0  2  3  1  1  2  3  3  1  3  1  2
2 2 0 3 3 1 1 3 3 0 1 1 3 2 2 3 1 3 0 1 1 1 2
23211033200101213023320
13300103321201133130220
21302021322000011111322
1 2 1 3 3 0 1 2 1 1 2 0 3 2 0 0 2 1 3 0 2 2 2
11121103233003222012010
3 3 2 0 2 2 3 2 2 2 0 0 2 1 2 1 0 3 2 2 2 2 2
0  3  2  0  2  3  2  2  0  2  2  0  0  2  3  3  2  0  0  1  2  2  0
33133302220000001211002
1 0 2 0 3 3 0 1 1 0 1 3 0 0 2 3 3 1 2 0 1 0 2
33330200221231221102302
3 1 0 1 2 3 0 1 2 2 3 0 0 3 2 1 2 1 1 2 2 0 2
20022330320110131102212
1 3 2 2 1 2 2 1 2 0 1 2 1 1 3 2 3 2 2 1 3 0 0
2 2 2 2 2 0 1 0 2 0 0 3 0 0 3 0 2 2 2 1 2 0 0
23012222010133212331112
2 3 2 0 3 2 2 0 1 2 1 1 2 0 0 3 3 2 0 0 3 2 2
1  3  3  0  0  2  1  1  1  3  1  2  3  0  2  1  3  3  1  3  1  3  2
1 1 0 0 1 3 1 2 0 1 1 0 2 1 0 1 3 0 0 0 3 0 0
00000100001111000001000
