3010222211132332231223312032
3 1 1 0 1 1 3 3 3 3 2 2 3 1 1 0 0 3 0 2 0 3 2 2 2 0 2 0
2222221031302022223323321120
0 0 3 3 2 1 2 0 0 0 0 1 2 3 1 3 0 0 0 0 1 1 3 0 2 1 1 2
2011023303003012033311110302
2  0  1  1  0  2  3  1  1  2  2  0  1  0  2  3  0  3  3  0  0  2  0  2  3  1  2  2
0  1  1  1  2  1  0  1  2  3  3  3  3  3  2  2  0  1  0  3  0  3  2  3  1  2  3  2
0  1  2  0  2  1  3  0  2  0  3  1  1  2  2  1  3  2  1  1  3  0  3  0  0  0  1  0
1 0 3 1 1 0 3 2 1 3 1 2 1 2 1 0 2 1 2 2 0 1 2 0 0 0 0 0
3 1 2 3 2 3 0 2 2 0 3 3 1 0 0 0 2 1 1 1 3 0 2 2 1 2 3 2
2 0 0 0 3 2 2 1 2 2 0 1 0 3 3 3 0 1 3 0 1 3 2 0 0 1 2 0
3  2  2  0  0  2  1  3  1  0  3  3  2  2  1  2  2  1  3  0  0  1  1  0  0  0  0  0
0  2  0  2  3  1  2  3  3  1  2  1  3  0  0  0  1  1  0  3  0  1  2  1  0  1  2  0
1  1  0  3  3  0  2  2  2  3  1  1  0  2  3  2  1  3  1  3  3  2  0  2  0  2  2  2
2  2  2  2  2  2  1  1  3  1  3  3  2  1  2  2  2  1  1  2  3  3  2  0  1  2  0  2
1  2  2  0  2  2  2  1  2  0  3  0  0  0  2  0  2  2  3  3  1  3  1  0  3  0  0  0
2  2  1  3  0  1  3  3  2  1  0  0  3  1  2  0  0  0  0  2  3  0  0  3  2  2  2  2
2230133201022330110211333332
3120131123020331130001203220
2 3 1 2 0 0 2 0 2 0 0 0 1 3 2 2 3 3 0 0 3 1 1 0 2 2 0 2
1  3  1  3  3  3  1  0  3  0  0  0  2  3  2  0  2  3  2  3  0  2  0  2  1  3  2  2
0 0 0 2 3 3 0 1 2 1 3 0 3 2 3 3 3 3 3 2 1 2 3 0 0 1 0 2
2  0  1  0  0  3  0  2  0  1  2  0  2  2  3  3  0  1  0  0  2  3  2  3  3  1  2  0
0  3  2  3  1  0  2  3  3  1  3  0  1  1  2  2  1  1  3  3  2  0  3  2  0  3  0  0
3  2  2  1  3  1  1  3  1  1  3  3  0  3  0  3  2  1  0  0  0  2  0  1  3  1  0  0
2  2  3  3  3  2  3  0  0  2  2  1  0  1  2  3  3  1  0  1  0  2  0  2  1  0  0  2
1101110100011010101111010010
