0  0  3  2  0  1  1  2  1  2  0  0  2  0  0  1  2  0  0  0  0
233220032310031110230
323212322310123212110
332102301100113200022
2  0  1  3  3  0  2  3  1  3  0  2  0  3  3  0  2  2  1  2  2
2  0  2  1  0  1  0  2  0  1  2  2  0  0  1  0  2  0  3  1  2
0 1 2 0 0 0 0 1 2 3 0 0 3 1 1 2 0 1 3 3 2
3  2  0  0  3  2  0  3  1  1  1  3  1  1  3  3  1  3  0  3  0
0  1  1  2  1  3  1  2  0  1  1  0  2  1  0  2  1  1  0  1  0
2 3 0 2 1 1 3 3 2 0 1 2 3 2 3 0 0 1 3 2 2
0 0 3 1 2 3 0 1 1 1 0 0 3 3 0 0 2 0 3 1 2
101021200333101113320
3  3  1  3  2  2  3  3  2  3  2  3  1  3  1  3  1  3  0  0  2
2  3  1  1  2  3  1  0  2  3  3  2  2  2  2  2  2  2  3  1  0
312112103123030001202
131331120113203113132
101213233320101222310
202311133323120233100
1  3  2  1  0  3  3  0  0  2  1  0  1  0  1  1  0  2  1  3  2
3 3 3 3 0 0 1 1 3 2 0 0 1 1 2 0 1 0 0 1 0
020200221300231101322
3 0 1 1 0 0 1 0 1 2 3 1 2 1 2 0 3 0 2 2 0
0  0  3  3  2  2  3  1  2  1  2  3  3  0  1  3  1  2  1  1  0
3 0 0 3 3 1 3 0 1 1 0 0 2 1 2 3 3 1 0 3 2
203231321223331012000
2 0 1 3 0 3 2 2 2 2 0 3 2 0 0 0 2 0 1 2 2
133201212012010332012
221003321001132210312
1  0  0  0  2  2  1  2  0  0  0  1  0  3  0  3  3  3  2  1  0
0  0  0  1  1  0  0  0  0  1  0  0  0  1  0  0  0  0  1  1  0
