20000131311212
1 2 2 2 0 3 2 0 1 1 3 2 0 0
21101331321032
33230131333200
21311021012100
00010100111100
