3  0  3  2  0  1  2  1  3  3  2  1  0  2  2  3  2  2  3  0  0  2  2  1  2  0  3  0  0  2
1 3 3 1 2 2 1 2 3 2 0 2 2 1 1 3 0 0 0 0 1 0 1 0 0 0 3 1 2 0
3  2  3  0  2  0  3  3  2  1  2  3  3  3  3  1  0  3  1  1  0  1  1  2  0  3  3  1  3  0
003313110112301312230211000030
002030010132221123311232132112
0 3 1 1 1 0 1 0 1 0 3 0 2 0 1 2 2 3 0 0 2 1 1 2 1 0 2 2 3 2
303021201130102333000233011102
330123131311331310120331000220
001323132231100222200113010032
333220232320013210320032131230
023323133022100111001123322030
1 1 3 0 0 2 0 1 3 1 0 3 3 2 2 0 0 2 1 3 1 0 2 1 0 0 3 3 3 2
200120013023301112321302333102
0 3 0 1 0 2 2 1 0 3 0 2 0 0 2 0 0 2 0 1 3 0 1 0 1 2 1 0 1 0
0 0 0 0 0 0 0 1 0 0 1 1 0 0 1 0 0 1 1 0 1 0 1 0 0 1 0 0 1 0
