3  2  3  3  2  3  1  3  0  2  2  3  0  0  0  3  3  0  0  0  2  2  3  2  0  2  0  0  3  0  2  3  3  1  0  2  2  1  2  2
1  2  1  1  2  0  3  1  1  2  3  0  3  3  2  1  2  3  2  2  1  2  3  2  3  1  0  3  0  2  1  0  2  0  0  2  0  1  3  2
0 1 3 0 3 1 3 3 2 3 3 0 2 2 2 0 1 2 0 1 0 1 3 2 2 2 3 1 2 0 1 3 0 3 0 1 0 1 2 2
1 1 2 0 1 3 3 0 3 3 3 3 3 1 1 1 2 3 2 3 3 0 3 1 3 2 0 0 0 2 0 1 1 0 3 2 0 1 2 2
0  3  0  1  3  0  0  1  0  3  3  3  1  3  2  3  1  1  1  3  1  2  3  1  3  0  2  3  2  3  1  3  0  1  1  1  0  0  1  0
1  2  2  0  0  3  3  1  2  0  1  2  3  0  3  2  2  3  2  1  3  2  2  0  3  1  1  1  3  0  0  1  1  2  1  1  0  2  2  0
0311230021012222312223323012122220313312
0  1  1  1  1  0  1  1  1  3  3  0  0  1  2  2  0  0  3  0  2  1  0  1  0  3  2  2  3  3  1  1  1  2  0  2  2  0  0  0
2 3 2 0 2 1 1 1 0 0 3 2 3 1 0 1 3 3 2 3 3 2 2 1 0 0 2 2 0 2 1 0 1 2 1 1 1 2 1 2
2032123333010022133320110102201022122022
3010010032212231330321111022211201323332
3  1  2  0  1  2  2  3  2  0  2  1  2  0  3  0  1  3  2  3  0  0  1  3  0  2  0  0  2  0  2  3  1  2  3  3  0  3  3  2
3 0 2 1 1 3 0 1 2 3 1 3 1 0 0 2 2 2 2 2 2 3 0 2 2 2 0 0 1 2 0 0 3 2 0 0 1 2 2 2
1  0  0  3  0  3  2  3  3  2  3  3  1  2  3  3  2  2  2  1  2  3  3  0  3  3  0  2  3  3  3  0  0  3  3  3  3  1  1  2
0 3 2 0 3 2 1 1 0 0 1 0 1 0 1 1 1 0 1 1 3 0 1 2 3 3 2 2 0 0 3 2 2 0 3 0 0 2 3 2
2033112131011031031033231203011300200120
3 3 3 0 2 2 3 3 1 3 3 0 0 1 1 0 3 3 3 0 1 2 1 0 1 1 2 0 3 1 2 2 1 2 1 0 1 1 1 0
3  1  1  0  0  1  1  3  3  2  2  1  3  1  1  0  0  0  0  2  2  0  0  1  1  2  0  1  3  2  0  0  1  0  2  3  2  2  1  0
3020013001310321300010321331103133303132
0 1 1 1 0 0 0 0 1 1 0 0 1 1 1 0 0 1 0 1 1 0 0 1 0 1 0 0 0 1 0 0 1 0 1 1 1 0 0 0
