133120332032123220222022131031112
1  0  3  1  3  1  2  0  0  1  0  2  2  2  1  3  3  1  1  3  0  0  0  0  0  3  3  3  3  2  2  0  2
3  1  1  1  2  1  2  3  1  3  2  1  0  1  1  1  0  0  1  2  0  2  1  0  2  2  1  0  0  1  0  0  0
0  2  1  2  3  1  0  3  3  0  1  2  2  2  2  1  2  1  0  3  3  1  1  1  0  3  2  3  1  3  1  2  0
3  3  3  1  0  1  0  0  3  0  1  1  0  3  0  1  3  2  2  0  2  2  1  0  1  0  3  1  2  2  3  1  2
1 3 0 1 2 2 0 3 1 0 2 0 3 2 0 2 0 0 2 2 3 2 2 0 2 1 2 0 2 0 1 2 0
230200300033232130212011021132212
212233031222103130200010320021302
1 0 1 0 1 2 3 1 3 3 0 1 2 0 2 1 0 2 2 1 0 0 0 3 2 2 2 0 1 3 0 0 0
2 2 2 1 2 1 2 1 1 2 2 2 0 3 1 0 1 0 0 0 2 0 1 3 3 1 2 1 1 2 1 1 2
122323230212320322302321330010310
100101010110001101011010011111100
