0  2  1  0  1  1  0  2  2  2  1  3  0  1  2  1  2  1  0
2  2  3  3  3  0  1  1  3  2  0  3  1  2  0  3  2  3  0
3  1  2  2  3  1  1  3  3  0  1  3  0  3  0  0  0  2  2
2113203321112030102
1011220310203003320
1  3  3  3  3  1  2  2  0  0  3  2  1  0  0  3  2  2  2
3  3  1  0  1  3  1  1  2  1  0  1  1  0  0  1  1  1  0
1 0 0 1 1 1 2 3 2 3 3 3 1 2 0 0 2 2 2
3 0 1 0 3 0 0 3 0 1 3 0 2 1 1 0 3 1 0
1033330022310210132
2 0 3 2 1 0 1 1 0 0 2 3 2 3 1 1 0 2 0
3300131203223302230
0  3  3  3  2  1  2  2  0  2  0  0  0  0  3  2  0  3  0
0  0  1  3  1  0  1  3  0  2  1  3  3  3  0  2  3  2  0
0 2 2 3 0 3 3 3 2 2 0 3 1 2 0 0 0 2 0
2  1  3  0  3  1  3  0  1  3  3  2  1  2  0  2  1  1  2
3  1  1  0  1  2  1  2  3  2  2  1  1  0  1  1  1  0  0
0  2  0  3  1  0  2  0  2  1  3  3  1  1  2  0  1  2  2
3223132013223112102
3  3  0  3  2  1  3  1  2  2  2  1  1  1  3  2  1  2  0
2  3  3  3  3  3  1  3  1  3  3  0  2  1  1  0  2  1  0
2100013112300130232
3300130230321133212
0 1 0 0 0 2 3 2 0 3 3 0 3 2 1 1 2 1 2
3310132111130300220
0 3 0 2 1 0 0 1 2 2 2 0 1 0 2 0 1 1 2
1  1  1  0  1  1  1  1  1  0  0  0  0  0  0  0  0  1  0
