110011103130122122211203302
213012222123213301033113032
012300331213201001101032222
222030220212320320032130322
1 0 1 0 0 1 0 3 3 1 0 0 1 2 2 3 1 0 1 1 3 1 2 2 3 0 0
200231311221021302330102002
2  1  1  2  1  1  1  3  2  3  2  2  3  3  1  3  2  3  2  2  1  1  3  2  2  0  2
2 2 0 1 3 1 0 3 0 3 2 1 1 0 1 1 2 2 2 2 2 3 2 1 1 2 0
220023022311320220121133020
3 2 2 1 0 1 0 3 1 3 0 2 0 3 0 1 0 2 2 0 0 1 0 3 3 3 2
2 2 3 1 0 3 2 1 0 2 0 3 3 2 2 1 0 3 2 2 2 1 3 1 0 2 0
320021112121102010022330102
123231030200131132121020320
1 1 1 2 2 3 2 1 0 3 1 0 3 3 3 1 3 2 3 0 0 1 2 1 0 2 0
2 3 0 3 0 0 2 2 3 2 2 0 2 3 0 3 3 3 0 1 0 3 1 0 1 0 2
3 3 1 1 2 3 1 3 0 2 3 0 3 3 1 3 3 2 3 1 0 0 3 0 3 1 0
3  3  3  3  0  3  1  0  0  0  2  0  1  1  2  3  0  3  1  2  2  2  0  3  2  3  0
0 2 2 1 2 2 1 0 1 0 3 1 0 0 0 1 2 2 2 2 0 2 0 2 0 0 0
031030133210303201131211310
001000111001100101010100100
