2 0 3 3 1 1 2 2 1 0 0 1 3 1 3 3 3 3 2 1 1 2 2 1 1 1 0 0 1 0 1 0 2 3 0 3 2 2 0 0 2
2  3  3  0  0  3  3  3  2  3  3  1  3  0  2  1  2  2  1  3  2  3  1  2  1  3  0  0  0  3  2  2  1  2  0  0  3  2  1  0  0
0 0 0 1 3 1 2 1 1 1 1 1 1 1 1 3 2 1 1 3 0 1 2 0 0 2 2 2 3 2 3 2 2 3 0 3 1 2 3 3 2
31330300233301022331032032030321332030332
22223202113122013232312112013233223301320
0 1 2 1 0 0 3 1 2 3 0 2 0 0 3 3 3 1 2 2 0 1 1 3 3 3 1 1 1 3 0 2 0 3 2 3 2 0 2 0 0
1 1 3 3 3 3 3 0 0 2 3 3 1 0 2 0 3 3 3 0 0 1 2 3 2 3 0 1 0 2 2 0 1 0 1 0 3 3 3 0 2
11223233021331000131323131212132233212220
1 0 0 3 2 2 3 1 2 2 0 1 1 0 0 3 1 3 0 3 3 1 0 3 2 0 3 1 0 3 2 0 0 3 1 0 2 1 1 1 0
0 1 2 0 0 0 2 0 3 3 3 2 2 2 2 3 3 1 0 0 2 1 2 3 0 1 0 1 1 0 1 0 3 2 3 0 0 2 3 3 2
33302100232200031112302023101230110312112
2 1 2 3 1 2 0 2 0 0 3 0 3 1 2 0 1 1 2 1 2 2 2 1 1 0 3 3 2 1 3 2 1 0 2 3 0 1 3 0 2
1 0 0 0 0 1 3 0 2 0 3 3 1 1 3 0 1 0 3 1 0 0 0 3 3 1 3 2 0 2 1 1 1 1 1 2 3 2 2 0 0
11000010011011000111010011101011101110010
