0 1 2 2 3 0 1 2 0 1 2 2 1 2 3 0 0 1 0 2 0
1  3  2  3  1  0  2  3  3  2  3  0  3  2  0  1  1  1  1  2  0
0 1 0 1 2 0 2 0 1 3 3 3 2 0 2 3 3 1 3 2 2
3 3 2 1 2 1 1 0 1 0 1 1 0 0 2 0 2 1 1 2 0
0  2  2  1  2  2  0  0  1  3  1  2  0  0  2  1  0  1  3  2  2
1 3 1 0 2 3 0 3 0 1 3 3 0 1 2 1 1 3 0 0 0
3 0 1 2 3 1 1 3 0 0 1 0 3 2 3 2 1 1 1 2 0
0  0  2  0  2  0  1  0  0  3  0  1  2  2  0  2  1  3  0  2  0
2 2 2 0 2 1 0 3 3 0 2 1 2 3 1 3 1 0 0 1 0
3  2  0  3  3  1  0  1  0  1  3  0  3  3  2  2  3  3  3  3  0
231113220123230311030
1 1 2 2 0 2 0 0 0 3 0 2 3 2 0 0 0 0 0 0 0
0  2  0  1  2  2  0  0  1  0  1  3  2  2  3  0  3  2  3  0  0
232111330103122021000
120303321201232030220
0  2  3  1  1  1  2  1  2  0  0  1  2  0  1  0  0  1  1  1  0
210112213320032031032
0 0 3 1 0 0 3 3 2 1 2 2 3 2 1 0 1 3 2 2 2
103133220030303212200
123332000231312112300
3 2 3 1 0 2 1 0 2 1 3 3 1 0 2 1 2 1 1 1 2
1 3 3 1 3 1 1 0 0 1 1 0 2 2 2 3 2 0 0 2 2
222320302110310032302
2 2 2 3 0 2 2 0 1 0 2 0 2 2 2 1 1 2 2 2 0
2 3 2 3 1 3 1 2 3 2 2 2 1 1 1 1 0 3 3 2 0
3 2 1 1 1 1 0 0 3 1 3 1 2 3 2 1 1 3 0 2 0
321231000010232113020
1  0  0  1  1  1  1  0  0  0  0  0  0  0  1  0  1  1  1  0  0
