2  1  2  1  2
3 2 1 3 0
3  2  1  2  0
2  0  3  1  0
01002
20322
0  2  1  3  2
0  0  1  1  0
20302
3 3 3 1 2
2 0 0 2 0
31102
12012
21310
1  3  2  2  0
2  3  1  0  0
00022
1  3  1  1  2
0  0  0  1  0
