3032023331102000303221112332300012031002
1021030131322113330021103211211010223032
0 1 2 2 2 0 0 0 3 2 3 0 3 3 2 0 2 2 3 2 0 1 3 3 1 1 0 0 2 3 1 1 0 0 3 3 1 1 1 0
0 0 3 0 3 2 2 2 0 3 3 0 1 2 3 1 3 0 3 1 3 2 1 2 3 1 3 1 3 0 1 0 0 2 1 0 3 1 2 2
3100130003213330223302112230303300201200
1130130320010130211203323123303100310102
2  0  3  1  0  1  1  0  2  2  2  2  3  3  3  3  2  0  0  3  2  1  3  1  3  0  0  1  1  0  3  2  3  3  3  3  2  3  2  0
3  0  3  3  1  0  2  0  0  3  3  3  0  0  0  1  3  0  1  1  1  0  3  0  1  3  0  2  0  0  2  1  2  0  3  0  2  3  3  0
1 1 2 0 1 3 2 1 0 1 3 2 3 3 2 0 3 1 2 1 1 0 0 2 3 1 2 2 3 1 1 2 3 3 0 3 3 0 2 2
3  1  2  2  1  1  2  3  3  1  3  1  3  3  3  2  2  0  2  3  2  0  2  2  1  1  0  0  0  2  1  0  1  0  2  0  2  1  0  0
1 2 2 0 3 2 1 1 3 3 3 3 0 3 0 3 3 3 1 0 0 2 3 3 1 3 2 0 3 3 1 2 3 1 1 1 1 3 0 2
2212001203002002030212023322031121103120
3  3  1  2  0  1  3  1  0  0  3  3  0  2  2  1  2  2  2  2  1  1  0  0  3  1  3  1  0  3  3  2  0  2  2  0  2  1  0  2
1 0 3 3 0 1 3 3 2 1 0 3 2 1 0 1 0 2 1 2 0 0 0 3 1 0 2 2 1 3 2 1 0 0 0 2 0 0 1 2
2 3 3 0 0 2 3 0 3 1 3 1 1 3 2 1 2 3 2 2 0 0 0 3 2 2 0 2 0 3 1 3 2 1 2 0 2 3 2 0
1223033320123212320302110130230000231030
3310213300102012312132232123300121303120
3 2 3 2 3 2 2 1 3 2 3 0 1 0 2 3 1 2 2 3 0 1 2 0 3 2 3 1 2 0 3 1 2 0 1 3 0 0 3 0
1200122001220201131013220210313220203302
0113023130301310200023332110100312122322
1  2  3  1  0  0  1  1  1  1  0  3  2  0  1  3  0  3  0  3  3  3  2  3  3  2  1  1  2  1  2  0  1  3  1  1  3  3  2  0
3  0  3  3  2  2  0  2  3  0  1  0  0  2  2  1  2  2  2  1  0  3  1  1  1  1  1  3  3  3  2  3  3  2  1  3  1  0  3  0
0210310113120120233101012010000120110000
0 0 2 3 3 0 3 0 3 0 1 0 3 3 2 2 0 3 1 2 1 3 1 3 3 3 2 2 3 0 0 2 2 2 1 0 2 2 2 2
1 1 0 0 1 1 0 1 1 1 0 0 1 0 0 0 1 1 1 1 0 1 1 1 0 0 0 1 1 0 1 0 1 1 0 1 1 1 0 0
