2 1 1 1 2
2  1  0  3  0
0 0 1 2 2
10012
00022
22110
1  0  3  2  2
1  1  2  0  0
0 3 1 2 2
1  1  3  1  2
0  0  3  0  0
0  1  3  3  2
0  3  1  2  0
0  1  2  2  2
20100
2  0  3  3  2
0  0  1  0  0
