101303203031232230333212211010002
2 0 0 2 0 3 2 1 2 2 0 0 1 2 1 0 0 1 3 2 2 3 2 1 0 1 1 2 2 2 0 3 2
0 0 2 1 0 1 1 3 0 3 3 1 2 3 1 3 1 1 0 2 3 2 2 0 3 3 0 1 1 1 1 3 0
2 1 1 2 3 1 1 2 3 1 3 1 1 3 0 1 3 1 0 3 1 1 2 0 0 3 2 0 3 0 2 3 2
130322132111201222102311122322100
0 2 3 0 0 3 2 3 1 0 2 0 1 2 2 0 0 0 0 1 1 2 1 1 2 1 0 0 3 0 3 1 0
2 0 2 2 0 0 2 3 2 2 0 1 2 1 0 1 3 1 0 1 0 3 2 1 3 2 3 3 1 1 1 1 0
2 0 2 2 3 0 1 0 3 0 1 1 1 1 0 0 1 1 2 0 1 2 0 1 0 1 1 1 2 1 0 1 0
223130201003202023203020020321020
1 1 2 0 0 1 2 0 3 1 1 0 2 0 2 2 3 1 1 1 2 2 3 2 3 2 3 1 1 0 0 3 2
313312212222310000133302032322202
0 0 1 1 1 1 1 1 0 1 1 1 0 0 0 0 1 1 1 1 0 1 1 0 1 1 0 0 0 0 0 0 0
