0  3  1  0  0  2  1  0  2  0  1  2
101122200120
302102000030
0 0 0 0 2 3 2 1 2 2 1 0
312113330212
232111000212
1 2 1 2 0 3 0 1 2 1 3 0
222321132202
311202312220
322033031132
113012130012
2  0  0  2  1  2  0  3  1  1  1  2
3 3 3 3 0 1 2 1 0 2 1 2
033000322232
0 2 2 2 2 3 0 0 0 2 2 2
1 2 1 3 3 2 1 1 0 2 2 2
2  0  2  1  3  1  1  2  1  2  2  0
110100100010
