003001313131133301110100031012231321130
3  3  1  3  2  2  2  2  2  3  1  2  3  2  3  3  0  1  3  1  3  1  3  3  2  1  3  1  3  1  0  1  0  3  1  1  0  1  0
3  0  3  0  3  1  0  1  1  3  1  0  2  2  1  0  0  2  3  3  3  3  0  2  1  1  1  0  2  1  3  3  3  2  0  1  3  3  0
311120332331122312202011020032030113112
2 3 3 2 3 0 0 2 1 2 1 1 3 2 1 3 2 1 2 0 1 0 2 3 2 2 0 2 2 3 3 1 2 3 1 2 3 2 0
1  0  2  2  1  1  3  1  1  2  2  0  0  1  1  3  3  3  1  0  3  0  1  3  1  1  1  3  2  0  3  0  3  1  0  0  0  1  0
2 1 1 0 0 0 0 0 1 1 0 2 2 3 0 3 0 1 3 3 3 3 2 3 3 1 0 1 3 2 1 3 3 1 0 0 0 0 0
1  2  1  0  1  3  1  0  1  2  3  1  2  3  0  0  2  0  0  3  2  0  2  0  3  3  3  2  3  2  2  0  1  2  1  2  3  2  2
1  2  3  2  0  1  1  1  2  3  3  1  2  3  0  3  1  2  3  3  2  0  3  2  3  3  3  2  3  3  3  2  3  1  2  3  2  3  2
0  1  2  2  0  3  0  2  0  0  1  0  0  2  1  3  3  1  1  2  3  1  3  1  2  2  0  2  2  0  0  0  0  0  2  3  3  1  0
023301213032101113332322330200203212330
2 3 3 2 0 2 1 3 2 2 2 2 0 0 0 1 2 1 2 2 0 0 2 1 0 3 0 0 2 2 2 1 3 0 0 2 2 0 0
312223313100023020023111321300031012332
201333312322303013031122112321200220132
3  3  1  3  1  0  1  0  3  0  2  2  1  0  3  2  0  3  2  0  2  3  3  3  0  2  2  1  3  0  1  2  3  3  0  1  0  2  0
323123123322300100131130013001203210102
1  0  1  0  0  0  0  0  0  0  0  0  1  0  0  0  0  0  1  1  0  0  1  0  1  1  1  0  0  1  1  1  1  0  1  0  0  1  0
