3  2  2  1  2  1  2  0  0  2  2  1  2  0  0  3  3  1  2  3  1  3  0  2  0  0  1  1  2  0  2  2  3  1  3  0  2
2110032231013300313210003223120111210
3 2 1 1 3 0 2 3 2 3 3 3 1 2 3 3 1 3 0 2 2 3 1 2 2 1 0 0 1 1 1 3 3 1 2 2 2
3  2  3  1  3  0  0  2  3  0  1  1  3  1  2  2  3  2  3  2  0  3  2  0  1  1  3  2  0  0  2  1  2  0  0  0  2
1311301002122120000222213303310132002
2  2  0  0  3  3  3  3  1  0  2  1  0  2  1  3  0  1  1  1  1  3  0  2  2  2  1  1  2  2  3  1  2  1  1  2  2
1  0  2  0  2  3  3  2  2  3  2  0  1  1  3  3  1  0  2  1  2  1  2  2  3  2  1  1  3  1  1  3  3  2  1  3  2
1100001223322022332213131231201110132
2 1 3 2 3 3 1 0 0 3 3 0 1 3 1 0 1 1 2 3 3 2 1 3 2 3 0 0 0 3 2 1 1 0 0 0 2
3  2  1  3  0  0  2  2  1  0  2  2  2  0  1  1  3  0  0  2  2  3  2  1  1  2  0  1  2  3  1  2  2  1  0  0  2
0 1 0 0 3 3 1 2 1 3 0 3 3 1 0 3 3 0 2 2 1 0 0 0 2 2 1 1 1 2 3 1 3 3 0 1 0
0  0  1  1  0  3  3  2  3  1  3  1  2  1  3  1  1  0  2  0  2  0  0  1  0  3  0  2  0  2  1  0  3  0  2  0  0
1 0 0 1 2 3 3 3 2 2 3 3 2 3 3 3 0 3 1 3 3 2 3 0 1 1 1 1 0 3 3 2 2 3 3 1 0
3 3 0 2 1 1 1 0 1 0 1 3 1 3 1 0 2 3 0 0 0 0 2 2 3 2 0 2 1 0 2 3 2 2 0 0 0
3  2  2  0  2  3  1  3  2  1  3  3  2  0  3  2  3  0  3  3  0  2  2  1  1  2  1  2  1  0  3  0  0  0  3  2  2
0 0 1 3 3 0 0 0 2 0 3 3 0 0 0 3 0 0 0 0 1 3 0 1 3 2 0 2 2 0 3 3 2 0 3 2 2
2  1  2  3  2  1  3  2  1  3  3  1  3  3  2  2  2  1  0  1  0  3  3  3  3  1  3  0  0  1  1  1  0  2  0  3  0
1 1 1 3 3 0 2 1 3 3 2 1 3 2 2 2 0 1 2 3 2 2 2 3 3 3 1 1 1 3 3 2 1 1 0 2 0
3013212222011010010133203201103210102
0 0 3 1 2 3 2 2 0 0 3 1 3 3 1 1 2 2 2 3 3 2 1 0 0 3 0 1 1 0 3 1 0 1 0 2 0
1331232202130300110020230133031131020
0 0 1 3 2 0 0 0 1 2 3 1 0 3 3 3 3 0 3 0 0 1 0 0 3 1 0 2 3 3 0 0 3 3 2 1 2
2  3  1  1  1  0  1  3  0  2  2  2  0  2  0  3  3  3  2  3  3  1  0  2  0  0  1  3  3  0  0  0  1  3  2  1  2
1 2 0 3 1 2 1 1 0 2 2 3 0 0 0 0 0 1 0 0 1 2 0 3 3 3 2 1 1 2 1 3 0 2 1 1 0
2113231113122310132323002320300300330
0  2  2  1  1  2  3  3  2  0  0  1  0  3  0  0  1  2  0  2  1  3  3  0  2  3  0  3  1  0  2  0  1  2  2  2  2
2  0  3  2  2  2  0  3  3  2  1  2  2  0  3  3  0  2  1  3  2  1  2  1  0  3  0  1  3  3  0  3  1  2  1  2  2
0300033130201122222201033233011031222
3  1  3  2  3  3  3  2  1  3  3  2  0  1  2  1  3  3  1  1  1  2  0  0  1  3  1  0  3  2  3  2  0  1  1  0  2
1 1 0 0 1 1 1 0 0 0 1 1 1 1 0 0 1 1 1 0 0 0 0 1 0 1 0 1 1 1 0 1 1 1 0 0 0
