3 3 2 0 2 2 1 2 1 3 2 0 2 0 3 2 0 3 2 1 2 3 1 1 0 1 2 0 3 0 2
0332023113230031201330231331132
0  0  3  2  0  2  0  2  2  1  0  0  2  2  2  2  0  1  2  3  3  1  0  1  2  2  2  1  3  2  2
3300003323213213112133102333220
0 1 1 3 1 3 1 2 0 0 1 3 0 2 2 2 3 2 3 3 1 1 0 0 3 0 1 2 2 2 0
1  3  1  0  0  2  2  1  3  3  3  2  2  0  3  1  2  2  0  1  2  1  1  2  2  1  3  0  3  3  0
0 1 3 1 1 2 3 3 2 1 0 0 1 3 3 1 1 1 0 1 1 1 0 3 0 2 0 3 2 0 2
2  2  0  2  0  2  3  3  3  1  1  2  0  2  0  0  0  1  1  2  3  1  1  3  3  1  3  3  3  3  0
2213011030321022301010022020000
3 1 1 1 2 2 3 3 3 0 2 1 1 3 0 3 1 3 1 0 1 1 3 2 1 3 0 3 1 1 2
1  0  0  2  0  3  0  2  2  2  0  2  0  1  1  1  3  0  3  1  2  1  2  2  3  2  1  1  0  1  2
1232111031321130211200323333232
1130313330302203222001213103010
0  3  1  0  3  3  0  0  0  1  3  3  0  3  0  2  1  0  3  2  2  3  0  1  3  3  2  1  1  0  0
1111011011100101010100011000110
