0  3  2  3  3  0  1  1  3  2  1  3  1  0  2  2  0  2  1  2  1  3  0  0  0  1  0  2  3  0  1  3  2
0  0  0  1  1  2  1  0  3  3  1  2  3  0  2  0  0  1  0  0  2  1  0  2  0  1  0  1  2  2  1  2  0
2  3  1  2  0  3  2  2  0  0  2  3  3  3  1  0  3  2  2  0  0  3  3  1  0  0  0  3  1  0  0  1  0
101023122301021203201111122033102
0 1 1 1 2 0 2 3 0 2 1 3 2 2 2 2 0 2 0 2 2 1 0 3 3 2 3 1 1 3 0 3 2
1 0 0 3 0 0 0 2 2 2 1 3 2 0 2 3 3 2 2 0 0 1 2 1 3 3 0 3 0 0 3 1 0
110022133011232003320130001320212
110200112022032300011113333311002
1  0  2  1  0  3  3  2  2  1  0  0  2  0  1  0  1  0  0  0  2  1  3  0  0  3  1  1  0  0  3  2  0
200120223021013213023101033331320
231012200331303123110133010200200
2 2 2 1 3 0 2 0 3 1 0 2 1 3 1 3 1 0 3 1 1 2 2 3 2 0 2 3 0 3 0 2 0
033330021131233112021210012030322
2 1 3 1 0 0 2 3 1 2 3 2 3 3 1 1 2 0 1 2 3 1 2 1 0 2 3 3 2 2 3 2 2
2  1  1  0  0  3  0  2  0  3  3  3  1  3  1  0  1  0  3  1  1  0  0  2  3  3  2  1  0  2  2  0  0
032200022312031313230112212112232
312133012123022100323322202211222
0  0  1  1  2  2  0  2  1  3  1  3  2  0  1  1  2  3  3  1  3  1  3  3  2  0  2  1  3  2  1  3  0
301203032321323130033331321011100
0 1 0 0 1 0 0 1 1 0 1 0 0 1 1 1 1 0 1 1 0 1 0 1 1 1 1 1 0 1 0 0 0
