2 3 3 1 3 2 3 2 0 0 3 1 3 2
10021202310112
2 1 0 1 3 1 0 3 3 1 2 1 1 0
2 1 3 2 3 2 1 3 3 2 2 3 1 0
13323303303022
1 3 3 2 3 3 2 2 1 2 0 2 3 0
00301221102300
1 1 1 0 3 3 2 1 1 2 1 2 3 2
3  0  1  0  2  3  1  3  0  2  1  1  2  0
33202320232110
32322232212330
10201112222010
3  0  0  3  1  0  2  2  1  2  0  1  2  0
02222123133000
3  1  1  3  1  1  3  2  3  3  3  0  1  2
00303232323300
13222323232320
0  2  0  2  2  2  1  2  2  0  0  3  3  2
1 1 2 3 1 2 1 0 2 2 0 0 2 0
0 2 3 3 0 2 3 1 1 3 1 1 1 2
3 3 0 3 0 3 2 3 3 2 0 1 3 0
21333123110112
01313220202302
2  2  1  0  1  1  2  2  3  2  1  1  3  0
0  0  0  0  0  0  0  1  1  0  0  1  0  0
