21013130103310222313103020220113232
3  0  2  2  2  3  2  3  2  0  2  3  3  3  2  0  3  1  1  2  2  1  3  2  1  0  0  1  0  2  0  1  0  1  2
1 3 2 2 3 1 3 3 3 2 2 2 3 2 3 3 0 1 2 1 3 3 0 2 3 0 0 2 1 0 2 3 1 2 2
3  2  0  2  0  0  2  1  0  1  3  1  0  2  1  2  1  3  1  1  3  3  2  0  3  3  0  1  3  1  0  2  0  1  0
02020232130213002133200001230011112
3  0  1  0  0  1  0  3  0  1  0  2  0  0  2  2  1  1  1  2  2  3  2  2  0  3  0  2  0  0  1  1  3  3  0
2 2 2 1 2 1 0 3 1 1 3 1 1 1 2 1 0 1 1 0 0 1 0 3 0 0 2 2 2 3 3 2 0 2 2
20201312032222301112000231003020312
32010221231110331330122112310300102
1 0 0 1 1 1 0 1 1 0 3 1 2 3 0 1 3 3 0 2 3 1 0 3 1 0 0 2 3 3 2 1 0 3 2
03122131333213310220311112331302110
13031200113211231321031330122211000
33300002210121203230012232122331102
1 2 0 0 2 3 3 3 1 0 3 2 1 3 3 0 1 2 0 3 0 3 0 1 1 1 0 3 3 3 2 1 2 1 0
0  1  3  1  1  2  1  0  1  2  3  0  3  3  2  0  3  3  3  2  2  0  2  2  3  0  2  0  2  1  1  0  0  1  0
1 2 3 0 3 0 0 1 3 3 0 1 3 3 3 3 1 3 0 1 3 2 2 0 1 0 3 3 0 2 2 2 2 3 0
22030020233221122300023331111212202
2 0 3 2 1 1 1 2 0 3 2 0 1 2 1 3 2 1 1 0 2 2 1 1 2 1 3 1 2 1 3 1 2 0 2
1 3 2 3 3 1 2 1 0 2 0 1 1 0 0 2 1 0 0 3 0 2 1 3 0 1 3 2 1 0 3 0 0 0 0
1  0  0  0  0  1  2  0  2  0  2  3  1  0  0  1  2  0  2  0  2  3  0  0  3  1  2  1  2  0  2  3  1  1  2
12102232123220002311322312311121112
22233122220132000212303123031302320
1 2 1 0 2 0 0 0 0 1 0 1 3 3 1 3 1 3 2 3 2 0 3 2 2 2 3 1 0 0 2 0 2 1 2
0  1  3  0  1  3  0  2  3  0  0  2  0  2  3  3  2  3  0  0  3  1  2  1  0  2  0  3  0  2  2  1  0  2  0
1 1 1 1 1 0 0 1 0 0 0 0 1 1 0 1 1 0 0 0 0 1 1 0 0 0 0 0 0 1 0 0 0 1 0
