30130120300022313333222110
0  1  0  3  3  1  2  1  1  0  2  0  3  2  0  0  3  2  1  3  0  2  2  0  1  0
3  3  1  1  2  2  0  2  3  3  0  2  3  0  2  1  1  3  0  2  3  2  2  1  3  0
30313230202310211300203030
32022121113113323312211012
3  0  2  1  3  1  1  0  3  2  3  0  2  3  2  1  0  2  1  0  1  3  1  1  2  0
0 0 2 1 1 3 0 3 0 1 2 3 2 3 2 0 1 0 0 0 2 2 2 3 2 2
21201313231320031303211010
3 1 1 3 1 2 1 2 2 2 0 0 0 0 2 3 0 3 1 3 3 0 1 2 3 2
2  2  0  3  0  2  1  3  2  2  3  0  3  3  2  0  2  0  0  2  0  1  3  1  2  0
1  0  2  2  0  3  1  1  2  0  2  2  2  2  3  0  2  3  0  1  3  0  0  2  2  0
01232131333210012302030210
3  2  2  1  2  3  2  1  0  3  3  3  3  2  0  0  3  2  3  3  3  2  0  1  3  2
3 3 2 2 2 1 2 2 2 0 2 3 2 3 3 0 1 2 1 3 2 0 0 1 2 2
3 0 2 1 2 0 0 2 2 3 2 1 1 2 1 3 0 3 1 1 0 2 2 2 3 0
1 2 0 0 2 1 1 2 1 0 2 2 1 1 0 2 1 2 1 1 1 3 2 2 1 0
3 2 2 3 3 1 0 3 1 1 3 3 3 0 0 2 1 1 0 1 0 3 3 0 0 2
1  0  0  3  1  2  1  3  3  1  1  3  2  2  0  0  0  0  3  3  2  3  1  3  2  0
1  2  2  1  1  1  2  2  3  0  3  3  3  3  0  2  3  0  0  1  1  1  0  0  0  0
0  2  3  2  3  3  3  0  3  3  3  2  1  1  3  3  3  2  2  1  0  0  2  3  1  0
1  1  0  1  0  1  3  2  1  1  1  0  2  0  0  0  3  3  2  0  3  2  3  2  1  0
0  0  1  3  3  1  2  1  3  2  0  0  3  0  1  1  0  1  2  0  0  2  2  1  3  2
21010021001130200030332202
33123220011313121131031030
10101111100111011110100010
