2 0 0 2 2 3 1 3 1 3 2 0 3 3 3 1 1 3 1 1 3 1 0 2 1 3 0
0  1  2  0  2  2  1  1  1  1  1  2  3  3  0  0  0  1  0  3  2  1  3  3  1  3  0
221122332103310310202003120
1 0 3 1 0 1 1 1 3 1 2 0 2 3 3 2 2 3 2 2 2 1 3 3 0 2 2
023003313132303122321012102
1 1 3 1 2 3 1 1 0 0 3 2 2 2 1 2 0 3 0 1 2 0 1 1 1 2 0
2 2 1 1 1 2 1 1 3 0 3 1 3 1 0 3 0 0 0 0 3 1 3 0 0 3 2
1 3 2 1 2 3 2 1 0 3 3 2 0 1 0 2 3 3 3 0 0 2 0 3 2 0 2
001021121113130122311011132
001110333131113233232211100
023100022031102330210013332
011022003313232013100231130
1  1  3  0  3  3  2  1  1  2  0  3  0  0  2  3  2  3  1  2  2  1  2  0  0  0  0
2  2  2  1  0  0  1  0  3  0  2  0  1  0  3  0  1  3  2  2  1  1  2  3  3  2  0
1  1  3  3  0  0  2  1  2  2  3  2  0  3  1  2  3  1  2  1  0  1  1  1  3  1  0
1  2  3  2  2  3  2  1  1  3  1  0  2  0  3  0  1  1  1  0  2  0  0  0  2  1  2
021333020013211120303102322
101020310331213323112232122
3  2  2  0  0  3  1  0  1  3  2  1  3  1  2  2  3  0  3  2  2  0  0  0  2  1  0
1 2 0 0 1 2 1 3 2 2 2 1 3 2 1 1 1 3 0 2 2 2 2 0 0 2 0
0 0 1 0 0 0 0 1 0 1 0 1 0 0 1 1 0 0 0 1 0 1 0 0 0 1 0
