3  1  1  3  0  2  3  2  3  0  1  3  2  3  3  0  2  1  0  3  0  1  1  3  2
2312012203232322021231010
0 3 1 0 0 1 3 1 2 2 2 1 0 2 2 3 1 0 0 1 3 2 2 1 2
3 0 1 0 1 3 0 1 0 0 3 1 3 2 0 1 2 2 0 3 0 1 0 2 2
3031133131312202303311220
2020230011323131101130200
0013123102132020222133322
1003133231100322113220330
2 3 2 2 3 3 2 0 3 3 2 3 2 3 0 2 1 3 0 0 2 2 0 1 0
2 1 2 3 1 2 1 0 2 1 2 3 0 1 1 1 3 2 1 1 3 1 0 3 0
3  0  2  3  3  1  3  2  2  0  3  0  1  1  3  2  2  1  3  1  1  0  1  3  2
0  0  3  2  2  0  1  0  0  3  2  1  3  3  0  0  3  1  1  0  1  0  0  3  2
2 0 3 1 2 0 1 3 1 0 2 3 3 1 3 3 1 0 1 3 0 1 0 0 2
3 0 1 0 2 2 3 2 2 1 2 2 0 0 0 3 2 3 2 1 3 2 0 0 0
2133222211103200310033132
3012301301203002202031320
3 0 2 3 3 2 1 3 2 2 1 0 1 1 3 3 1 0 3 1 3 2 2 3 2
3001311320323233011212322
0212231022023000012122032
3013321302311323312321200
3  0  1  1  0  0  1  2  1  0  2  2  0  2  0  3  0  1  2  1  2  3  0  2  0
2 3 1 0 1 1 3 3 3 1 1 3 0 0 1 2 2 0 3 1 0 2 2 2 2
3 2 2 2 2 0 0 3 2 0 0 3 1 2 0 2 3 0 3 1 3 2 1 2 2
2  1  1  3  3  2  3  1  0  3  2  3  2  3  0  2  1  2  2  2  0  2  3  2  2
2113033201332012201112220
1 2 3 3 1 2 1 1 1 2 3 2 0 2 3 2 3 0 1 2 3 2 0 3 2
1 2 0 2 0 0 0 1 1 1 1 1 0 3 0 2 2 2 3 0 2 2 3 2 2
1 3 2 2 1 0 0 3 1 2 0 0 0 0 3 0 3 3 1 3 1 1 1 3 0
3  3  3  2  2  1  3  3  3  1  3  3  2  2  2  0  3  2  3  0  0  3  3  2  0
0  0  1  1  1  1  0  0  0  0  1  1  0  0  1  0  0  0  1  0  0  0  1  0  0
