23210102323110210320302113322022
3  1  3  3  2  2  1  1  2  1  3  2  3  1  3  2  3  1  3  1  1  2  1  3  3  1  3  2  1  2  1  0
0  3  2  3  2  1  0  0  2  3  2  0  0  1  1  2  2  3  1  0  3  0  3  0  2  1  1  0  0  1  3  2
13102230333033032113000332211112
1  2  2  3  3  0  3  1  2  1  3  3  2  3  2  1  0  0  0  3  3  0  3  3  2  1  2  0  3  1  3  0
3  2  2  2  0  0  2  3  3  2  0  3  2  2  1  2  0  0  0  2  0  1  2  3  3  0  2  1  1  2  2  0
02120332013332312312220111222120
23212203221201313133200312132010
2  3  0  0  2  1  0  1  1  2  1  1  0  1  0  0  2  2  2  1  3  2  1  0  0  1  0  0  2  1  0  2
2 1 3 1 0 0 0 2 0 3 2 3 0 0 0 0 1 2 2 1 3 0 1 1 1 0 2 0 0 2 1 2
30230002211211112221220023313330
11111111011111110110100100110100
