3  0  3  1  3  1  1  2  3  2  3  0  3  2  1  0  3  3  3  3  2  1  0  3  2  3  2  3  0  2  3  1  0  0  3  3  0
2232221133322331313331200112001302302
2000133100233030123210220212220011110
1 1 1 0 0 0 1 2 3 2 0 1 0 1 1 0 1 1 0 1 3 1 0 1 3 1 2 2 3 1 2 1 1 1 3 0 0
0 1 1 2 0 0 3 3 1 0 2 0 0 3 0 1 2 2 0 0 2 2 1 0 0 3 0 2 3 0 1 1 3 0 3 2 0
3 2 1 3 2 0 2 1 2 2 2 0 1 0 3 0 3 1 0 2 0 1 0 0 3 2 0 3 2 2 0 0 2 2 2 2 2
2  2  3  0  0  1  1  0  1  3  1  0  3  1  2  2  2  3  0  3  2  2  0  0  3  3  3  0  3  0  1  1  0  1  2  3  2
2  0  3  0  3  0  3  2  1  0  3  2  2  3  1  0  2  3  2  2  0  3  2  3  3  1  1  3  1  0  2  1  0  2  0  1  2
1023031212300110113212003212310131000
2  2  3  2  1  0  0  2  0  1  1  1  0  3  3  1  0  0  3  2  0  2  2  2  1  1  3  1  3  3  2  0  0  3  3  3  2
2 2 1 3 1 1 0 3 3 0 3 0 3 2 2 2 1 0 3 3 2 2 0 1 1 1 3 1 0 2 3 0 3 3 2 2 2
1  1  1  3  0  3  1  1  2  1  3  3  3  3  1  2  0  1  0  2  0  2  2  1  0  3  2  2  0  1  3  0  0  2  1  3  0
1  3  0  0  3  1  3  0  0  1  3  2  0  2  3  1  2  3  0  3  1  0  1  1  2  0  0  1  2  1  0  1  0  3  1  2  0
2  0  3  3  3  2  3  3  1  1  2  0  1  2  3  2  3  2  3  1  3  0  1  1  0  1  1  3  2  0  0  0  2  0  3  1  0
0  3  3  1  3  1  0  1  3  0  1  2  2  1  3  3  1  1  3  2  2  1  0  2  0  3  1  0  0  3  2  1  0  2  2  3  0
3 0 0 3 0 1 2 2 2 3 2 2 1 3 0 2 0 3 2 2 3 0 0 0 0 1 0 3 0 2 2 1 3 1 3 0 2
1132221221223201002203310322203313020
3 0 1 3 3 1 0 3 1 2 0 0 1 2 3 2 0 1 3 1 0 3 1 2 1 2 1 3 2 3 2 0 0 0 2 1 2
3023302310210232232212210033322322030
1  2  3  2  0  3  3  0  1  2  1  0  3  0  1  3  3  1  1  0  0  1  2  0  1  0  3  0  2  3  1  0  3  1  1  1  0
0110320211201021220033033220212012032
1  0  1  0  0  0  0  0  1  0  1  1  1  0  0  0  0  0  1  1  0  0  0  1  1  1  1  1  1  0  0  0  1  1  1  0  0
