3  2  1  2  1  2  2  0  0  3  1  2  1  2  3  2  1  0  3  2  0  2  1  1  2  3  0  1  2  3  3  2  1  3  1  0  3  3  2  0
1  3  1  2  2  1  1  1  1  1  0  3  0  1  2  3  2  0  1  3  2  1  1  3  3  2  1  0  3  1  0  1  0  0  1  3  2  2  0  0
1  0  2  3  0  0  3  0  0  0  3  2  0  0  1  0  3  2  2  1  3  0  0  2  1  3  2  2  0  3  0  2  3  3  3  2  1  2  0  0
0  1  2  3  0  3  0  1  2  1  1  1  3  0  0  0  2  0  1  3  2  1  2  0  3  1  1  3  2  1  0  0  0  0  2  0  2  3  1  2
1 0 2 0 1 0 2 0 1 2 0 2 2 3 2 0 0 1 2 2 3 2 0 3 3 1 1 0 2 3 1 3 3 3 1 0 1 1 2 2
1012103030002111013300131130210001220310
2 1 2 3 1 3 1 3 3 0 2 1 1 0 3 1 1 1 1 3 0 2 1 3 2 1 2 1 3 1 1 0 0 2 2 0 3 2 3 2
2022000123300322310111300202100320020032
1 3 0 0 0 3 2 2 0 0 3 3 2 2 0 3 1 3 1 1 1 0 0 3 2 3 2 3 3 1 0 3 3 3 0 1 3 2 1 2
2103131003302133103123121201332120310220
0 0 2 2 1 3 3 1 0 1 1 2 2 2 0 0 1 0 2 3 2 2 1 1 1 2 0 1 0 2 1 3 3 3 2 0 2 1 1 2
3022200023330330031131100213322321302100
1313301223223330211123111110212013003220
3023313013031213321231121103330112131130
0  0  2  2  0  0  3  1  3  3  3  1  1  3  2  2  1  2  1  3  0  2  2  0  3  1  3  0  0  1  0  1  2  3  0  1  1  0  0  2
2  3  0  2  3  0  2  3  0  3  0  2  3  1  2  2  3  0  0  3  1  3  1  1  3  1  3  3  0  0  2  3  2  2  2  1  3  1  2  2
1001303232223020233322103011231222212030
0 3 3 1 3 0 3 2 2 0 3 1 2 2 2 0 2 1 1 1 0 2 3 2 1 0 2 0 2 2 0 0 0 0 1 2 1 0 3 0
3  0  0  3  1  2  3  0  0  2  2  2  2  1  2  1  0  0  1  1  2  2  2  3  1  3  3  1  1  2  0  3  3  3  0  1  3  0  3  2
1101111110010000100101010110100111110110
