1 2 3 3 3 3 0 3 1 1 1 1 3 0 1 2 0 1 3 2 3 1 1 0 3 1 0 2 2
33332213211102231123103203330
0  3  0  2  0  1  1  2  3  0  2  3  3  2  0  2  0  1  1  0  1  1  0  0  3  3  3  1  2
0 1 2 2 2 3 2 2 3 2 0 1 2 3 2 1 1 3 2 1 1 3 1 3 2 1 1 3 2
22312013223302322230121033220
3  0  2  3  2  3  1  0  3  1  1  2  2  2  3  0  0  3  2  3  0  3  2  3  0  3  0  3  0
0 2 3 1 3 3 3 1 0 1 1 3 1 1 2 2 3 0 3 0 3 0 0 1 0 3 0 0 2
3 0 2 1 1 1 0 0 1 0 2 2 3 3 3 3 3 0 2 0 0 0 2 3 3 0 1 0 0
2  1  3  2  1  2  2  0  1  1  1  1  1  2  2  1  3  2  0  0  3  2  2  2  2  3  2  3  0
3  2  0  3  2  1  0  2  1  0  2  0  3  3  0  2  0  2  3  0  0  0  2  3  1  0  0  1  2
3  3  2  3  3  2  3  2  1  0  1  0  1  0  3  2  3  3  2  0  3  3  2  3  2  0  0  1  2
3  2  3  1  1  3  1  2  3  0  2  1  2  0  2  2  0  0  3  3  0  0  1  2  1  2  3  2  2
2  1  1  3  0  2  3  1  1  1  2  0  1  2  0  0  2  1  0  3  3  1  0  3  2  1  0  2  0
31112100210210300331113220230
3 3 0 1 2 2 1 2 0 2 1 0 1 2 0 2 2 3 1 0 1 3 1 0 3 3 2 1 2
00201133032300033030301122132
13031210031311310030230222312
11313200212302111220311211330
2  0  0  0  0  2  3  2  0  3  2  2  1  1  1  1  3  3  1  3  0  3  0  3  0  0  2  3  0
00101111101010001100000111110
