0 3 2 2 0 2 3 3 1 2 2 3 2 2 1 2 3 2 1 1 0 1 3 2 2 3 0 0 0 0 1 1 3 3 3 0 3 2
0  0  0  2  0  2  1  1  1  3  2  0  0  3  1  0  1  0  3  1  0  3  0  0  1  1  1  0  2  0  2  0  1  0  2  2  2  0
0 1 2 0 2 3 3 0 1 1 2 0 3 3 2 1 0 3 2 1 2 1 2 3 0 3 0 2 2 1 0 2 2 2 2 2 0 0
10331311200032210220211001021101210220
22020010011101113331132121011311011020
03202020122322130222132210211210101030
1 3 3 3 1 2 2 0 0 1 2 3 2 2 1 3 0 0 0 2 0 2 1 0 1 2 1 2 2 0 2 0 2 2 1 3 1 2
3  2  2  2  1  3  1  2  2  0  0  2  2  2  3  2  2  1  2  0  2  3  0  1  0  2  2  2  3  0  3  1  1  3  0  1  1  2
01110001110011100111100000011000011010
