3  0  1  2  3  3  1  1  2  1  0  3  1  2  3  3  3  3  1  3  1  3  0  2  1  0  1  3  1  1  0  3  2  1  2
1 1 3 3 1 0 0 0 1 1 1 0 1 2 2 1 0 0 3 0 0 1 3 0 1 2 2 1 3 2 2 2 2 2 0
2  2  0  0  0  0  1  3  0  3  0  1  2  2  3  2  0  0  2  0  1  2  2  3  3  1  2  0  0  2  0  0  1  0  2
00311110123210113033232200303303200
02032222012003222301112131333031100
2 1 2 2 3 2 2 1 0 0 2 3 0 2 3 3 3 1 3 2 0 0 1 1 2 0 3 0 3 0 1 3 1 3 0
3 0 0 1 3 1 1 3 0 3 0 2 2 0 2 3 1 1 3 1 0 1 3 0 0 2 2 0 1 1 1 0 2 1 0
2 0 1 3 1 2 2 3 1 3 2 0 2 0 1 0 0 1 0 2 2 0 2 2 1 3 2 0 3 3 1 0 3 3 2
1  3  3  1  2  1  0  2  3  0  1  1  3  3  0  3  3  2  0  0  1  0  0  2  3  3  0  2  2  3  3  2  3  0  0
3 1 3 0 1 2 2 0 0 0 0 2 3 1 3 0 2 2 3 0 3 0 0 3 3 1 3 3 3 2 1 1 2 2 2
13302132120331021202232230230111112
3 1 2 2 0 0 2 3 2 1 2 1 2 0 1 1 1 1 0 2 0 2 3 0 3 0 3 1 3 2 3 1 2 0 2
00121133313301212030301223212312330
2  1  0  1  3  0  3  0  0  0  3  3  1  1  2  2  1  1  1  2  3  0  3  2  2  2  1  1  3  2  1  3  2  0  2
32203222203201003300130232311331012
0 0 0 0 1 2 0 1 1 3 3 1 1 3 3 3 2 0 0 3 1 1 1 1 2 1 1 3 2 3 0 2 0 2 0
3 0 0 2 0 3 3 1 0 1 2 2 2 3 0 2 1 2 1 3 0 3 1 1 1 3 2 3 0 0 3 2 0 3 2
01331031313330302002223211220200112
2  1  1  3  2  2  1  1  1  3  0  2  2  2  1  0  3  0  3  0  1  1  2  0  2  2  1  3  0  1  2  3  2  0  0
1 2 2 2 3 3 1 3 2 3 3 1 0 0 1 2 1 3 0 1 3 1 0 2 2 3 2 2 1 1 3 2 0 2 2
1  1  3  2  0  3  0  3  3  1  0  3  3  1  0  0  1  0  3  0  3  2  1  1  3  2  3  0  2  0  1  1  2  2  0
1  3  3  3  0  0  2  0  0  3  1  2  2  2  1  1  3  1  3  1  3  0  0  1  0  3  2  3  3  2  2  1  0  0  0
30032330313320203102212030222212020
23301003222133113300122132113100302
3  0  0  1  0  3  2  0  2  0  0  3  2  3  3  1  0  0  3  2  1  0  1  3  0  3  0  1  1  0  0  0  0  2  0
3 2 3 3 3 3 0 1 3 3 2 2 2 3 0 1 3 0 0 2 3 0 1 0 0 2 1 3 2 2 0 2 1 0 0
0 0 1 0 0 1 0 1 1 1 1 0 1 1 1 0 0 1 0 1 0 0 0 0 0 0 1 1 0 0 0 1 1 1 0
