1 2 2 3 3 3 1 2 0 2 0 3 3 2 2 2 2 2
2 1 0 2 3 2 3 0 3 2 1 2 0 1 2 2 1 2
100122321221012130
0 0 1 2 1 2 1 1 1 3 1 3 1 3 2 0 2 0
2 2 1 2 0 3 1 1 2 0 3 0 3 2 3 2 1 2
310230130131311020
3  2  3  2  2  0  3  2  1  0  3  2  3  0  0  0  3  0
210332233223030222
3  0  0  1  2  1  1  2  3  2  0  2  2  1  3  2  2  0
232212312312311222
2  1  1  2  2  2  1  0  2  3  0  0  2  1  3  1  2  0
0 3 1 1 2 0 2 1 1 0 2 1 2 2 2 1 1 0
3 0 3 1 1 3 1 1 3 3 0 0 2 3 0 1 0 0
0 0 0 2 3 0 3 1 0 1 3 3 2 3 2 3 1 0
2 2 2 2 3 0 3 3 3 3 2 3 2 0 1 2 1 0
2 2 2 3 2 2 1 2 1 1 3 0 0 3 1 0 3 0
310110120102331100
0  0  0  1  0  1  2  1  1  3  2  1  0  3  0  3  0  0
100010001111111100
