3 3 2 2 1 1 0 1 3 3 2 2 3 3 2 0 0 0
311332330322113222
212120301311002320
301301010023202322
2  0  1  1  3  0  3  0  2  0  0  0  0  3  3  2  1  0
0 0 0 1 1 0 2 0 2 2 1 3 2 2 0 0 3 0
0 2 0 0 3 2 3 1 2 0 1 3 1 3 1 1 3 2
3 0 2 0 2 1 3 1 3 2 2 3 3 1 1 2 3 0
132103331000232100
301331331113102100
2 2 0 1 2 0 2 2 0 3 2 2 1 1 3 3 2 0
1 3 2 0 0 1 2 3 3 2 1 3 0 1 1 3 3 0
130201031001313000
1  1  1  3  1  2  1  3  1  0  1  2  1  1  1  3  2  0
1  0  2  0  0  3  3  3  0  3  2  3  1  2  1  3  0  0
3 0 3 0 3 1 1 0 3 1 3 2 1 2 3 2 2 2
1 1 3 2 3 0 1 2 1 2 0 1 2 0 1 2 0 0
2 1 0 0 3 0 1 1 2 0 1 1 3 0 0 2 1 0
122112113112122112
1  0  1  0  1  2  0  1  1  3  2  3  2  2  2  1  1  0
011323322201333220
1 3 0 2 2 0 2 2 2 3 1 2 2 1 3 3 3 2
3 3 3 1 1 0 2 1 1 3 3 2 2 0 2 3 0 0
303320012322230230
2  2  2  0  3  0  0  1  3  1  3  2  0  3  3  3  2  0
303033313100120212
3 3 0 2 3 1 2 2 3 0 3 2 2 3 0 1 3 0
3 3 3 0 1 2 2 2 2 2 3 2 2 3 0 0 3 2
011201231022110030
0 0 0 0 0 0 0 1 0 0 0 0 1 1 1 1 1 0
