1 3 3 3 1 3 0 2 0 0 3 2
3 2 1 1 0 3 0 3 3 2 1 0
3 2 2 0 3 2 2 3 2 1 1 0
332303022130
002030033020
0  1  1  0  3  2  2  3  0  0  3  0
313311112112
2  0  3  1  0  3  2  0  3  3  3  0
103311022112
001123211230
0  2  3  2  0  1  1  1  0  0  0  0
102022123010
211330232120
2 0 3 1 2 2 2 3 3 1 3 0
3 3 0 1 2 3 3 2 2 2 1 0
233211231212
0  3  3  1  0  0  0  0  3  2  0  2
3 0 3 2 3 2 1 2 1 2 2 2
1 2 3 0 3 1 2 3 1 3 3 2
3 0 1 2 1 1 2 3 3 1 3 0
3 3 0 3 3 3 3 2 0 0 3 2
312223232300
011132302110
1 3 3 1 3 2 0 2 3 0 0 2
1  0  0  1  1  0  1  0  0  1  0  0
