23311300313232233130
1  2  3  2  3  3  0  2  2  2  2  0  1  0  3  0  3  2  3  0
2 2 0 1 2 3 3 3 1 2 1 0 3 3 3 0 1 0 0 0
2  3  2  2  3  0  2  0  1  3  3  0  1  0  1  0  1  1  1  0
2 2 0 1 3 1 2 2 2 1 1 3 0 0 3 3 2 2 3 0
31203322100333200210
3  0  0  2  2  0  0  2  2  1  1  3  1  1  1  1  2  1  1  0
22123330300131000330
03103322123223300320
0 3 3 3 0 2 2 3 2 3 1 2 1 3 0 0 1 0 3 0
2  2  3  0  1  0  0  3  3  2  2  3  2  2  0  0  3  3  2  2
0 0 0 3 1 2 0 2 3 2 0 1 1 3 0 2 0 1 0 0
10000220211333013100
0 2 3 3 0 3 3 2 2 3 2 2 3 3 3 3 0 2 3 0
1 3 2 2 2 0 2 1 2 2 0 0 0 1 0 0 0 0 3 2
0  3  2  1  0  0  2  0  0  3  3  2  0  1  2  3  2  2  3  2
3 3 1 2 2 0 1 2 0 3 1 0 2 3 2 3 2 0 3 0
3  1  3  2  1  3  2  0  3  3  3  0  0  3  1  3  0  2  1  2
20133032211112011222
1  0  2  3  3  0  3  2  0  2  0  2  2  2  3  3  0  2  2  2
01000000110101000100
