2  3  3  3  0  0  1  0  1  3  2  0  1  0  0
1 0 2 0 2 1 0 1 1 0 2 3 3 3 0
0  2  2  1  3  1  0  3  2  3  3  2  3  2  0
2  0  2  1  0  1  2  2  2  3  1  0  2  2  0
2 3 1 0 1 1 1 0 3 3 3 3 2 3 2
101030311331320
3  1  0  0  1  3  3  0  3  2  2  3  2  0  2
303212021022320
122323323013222
1  2  0  2  2  0  2  1  1  1  3  1  3  0  2
233210121012030
000000212111322
230310301001112
030102313033132
2  0  1  0  0  3  1  0  3  3  0  0  0  1  0
220020312301312
1  1  1  1  3  3  2  0  1  3  3  1  3  1  2
2 2 0 1 0 3 2 1 0 2 1 3 3 1 0
2 2 1 3 2 2 2 2 3 1 3 1 2 0 0
302203111010212
2 1 0 2 0 3 0 2 0 1 3 3 1 1 0
301132111022222
1 1 1 3 3 2 2 2 1 1 2 2 3 3 2
101023110020210
033033012313100
020001031001300
3 1 1 0 3 0 3 2 3 2 0 0 2 0 0
0  2  2  0  0  0  1  3  0  1  0  1  1  0  0
1  1  3  0  0  0  2  3  2  3  0  3  0  1  0
020200112010220
100001011101110
