01320030320013120220
0  3  0  1  3  1  2  0  3  0  0  3  0  0  1  1  3  1  1  2
11010212023211202310
23301111112002212020
0  3  2  1  3  3  1  2  0  3  0  3  3  2  2  3  3  0  0  0
02220331130321003022
0  2  0  1  3  1  0  2  0  0  2  0  2  1  1  3  3  3  1  0
02022300322311223010
3 0 2 3 1 3 1 1 0 2 1 1 0 3 2 1 2 1 3 0
12131303030303303130
00003313300323211320
3  2  3  2  1  0  0  2  3  0  3  1  3  0  2  0  2  0  3  0
2  0  2  1  1  1  3  3  3  3  1  1  0  1  2  0  1  3  3  2
32013003100221323112
31320011103132001302
00111110001111010000
