0  2  0  3  1  3  3  2  3  3  0  0  3  1  3  3  2  0  0  2  0  3  3  3  2  1  0  3  0  0  1  2  1  2  2  1  0  2  2
1 3 1 2 0 0 3 3 3 2 0 3 0 3 0 0 3 0 0 3 1 0 0 0 1 0 0 1 0 0 0 2 3 2 3 0 2 3 0
0  1  3  0  3  2  3  1  3  0  1  0  0  2  2  3  0  1  2  1  3  2  0  0  1  0  2  2  1  0  3  1  0  1  2  3  0  0  0
2  2  3  1  3  2  1  0  1  1  1  1  1  1  3  2  0  1  3  1  1  1  0  2  3  3  2  1  1  0  2  1  0  0  2  3  2  2  0
011230233100113001320230302020131300230
1  0  2  1  2  2  0  0  1  2  2  2  3  3  0  2  2  2  2  2  2  2  0  3  1  0  0  3  3  2  1  3  2  3  0  1  0  0  2
223033210211120032330310110220031202210
0 2 1 3 3 1 0 2 3 3 3 0 2 2 2 1 2 3 1 1 1 3 0 0 1 0 1 3 2 3 1 0 3 1 2 1 0 3 0
2 0 2 0 0 3 0 2 2 0 1 1 1 2 2 2 2 2 1 1 1 0 1 1 0 1 0 2 0 0 1 1 0 2 0 0 3 0 2
010102101331101222322203110132103220122
133033202323203213202321202110221132112
2  2  1  0  1  2  1  3  3  3  0  0  0  3  2  1  2  2  3  3  3  0  0  2  1  2  2  2  0  2  0  2  2  3  1  2  2  3  2
1  1  1  2  0  2  3  1  2  1  2  2  1  2  3  2  0  0  0  1  3  3  2  3  3  3  3  0  3  3  3  0  2  0  2  0  0  2  2
220311000202302023022113001321013333012
112000100122013312032121122220021022000
3  1  2  2  2  1  1  2  0  2  0  0  0  2  1  2  2  3  1  2  0  2  1  3  3  1  2  3  3  2  2  3  0  1  1  1  1  0  2
300333213211103123013331230321300313322
1  1  2  0  1  2  0  0  1  3  3  0  0  2  1  3  1  0  3  3  0  1  2  2  3  1  2  3  3  2  3  3  3  3  0  0  3  1  0
1  3  2  1  3  0  0  0  0  0  1  3  3  1  1  2  0  3  2  0  1  3  2  1  1  3  0  0  3  2  1  0  0  0  1  3  3  0  2
300100220021311020020012303310121333032
1  1  3  2  0  2  3  3  2  1  1  2  2  2  0  2  3  2  2  0  0  2  0  2  0  2  2  0  0  0  0  0  1  0  2  2  2  3  2
1 3 1 3 3 0 3 2 0 2 3 3 0 3 3 2 1 0 2 2 3 3 2 1 0 3 2 3 1 1 0 1 2 0 0 3 2 0 0
3  2  1  3  0  1  0  3  1  2  1  2  0  2  1  3  0  2  1  3  3  3  0  1  2  0  1  3  2  1  2  3  0  2  1  2  0  2  0
1 3 0 0 3 2 3 0 0 0 1 3 3 3 3 0 2 0 0 1 0 3 3 0 0 1 2 2 0 1 0 2 0 0 2 1 3 1 0
2  3  0  3  0  3  1  2  0  1  0  0  2  0  0  1  3  1  0  1  1  1  0  2  2  3  0  2  3  1  1  0  1  0  1  1  2  1  2
121201102332301012320212032130022222022
110001101011000100100011010111100000100
