1  2  2  0  3  2  3  2  2  3  1  1  0  3  2  0  0  0  2  2
12010033312230121232
0 0 2 1 1 3 0 3 0 1 0 2 1 3 2 2 2 0 0 0
13112123232002312202
0  3  0  0  2  0  3  3  3  3  1  2  3  2  2  2  1  1  3  0
33132211120331200200
22211103032013230110
3 3 2 1 3 1 2 0 2 2 1 1 2 2 3 3 3 2 1 0
12302120112001222132
1  2  3  0  2  3  1  0  2  3  1  2  0  3  0  3  2  3  2  0
13220010332222002120
1  3  0  3  2  3  1  3  3  0  1  3  2  0  3  2  1  3  1  2
2  0  0  3  0  1  3  3  3  1  1  0  0  1  1  0  0  3  3  0
0  0  2  1  3  1  0  1  1  2  2  0  1  3  2  0  3  0  2  0
10020120333210211022
11323131200012321200
30022101221332212102
2 0 2 1 1 1 0 2 0 2 1 2 3 3 2 3 1 2 2 2
1  0  1  1  3  0  2  0  3  0  0  3  2  3  2  0  1  0  0  0
2 3 1 2 2 1 2 1 1 0 3 3 2 3 1 0 2 3 3 2
1  2  2  2  3  2  3  1  2  2  2  2  2  3  1  3  0  3  3  0
1  2  0  0  2  3  3  1  3  1  3  0  3  2  0  0  0  3  2  0
3 3 3 0 1 3 2 0 1 2 0 1 2 1 0 1 2 1 1 0
32021231220110033332
13121200200111303100
21313221122231200132
1  0  2  2  0  1  0  3  2  0  1  1  0  3  1  3  0  2  1  2
3 1 3 3 2 1 2 2 1 0 3 3 1 2 2 3 0 0 3 2
2 3 1 0 1 0 0 3 0 2 2 3 1 0 2 2 3 0 0 0
3  1  1  3  3  2  2  2  1  1  1  2  2  0  1  3  2  1  2  2
1 0 0 1 1 0 0 0 1 1 1 0 1 1 1 0 1 0 1 0
