0211002031230133022020
1302033032313110231120
3  1  2  3  1  2  0  3  1  3  3  0  3  2  2  0  3  0  3  3  0  0
1131321302111221113122
1 3 0 2 0 0 0 3 0 1 3 0 2 2 3 2 0 3 2 0 0 0
2 2 1 2 0 2 0 0 0 2 0 0 0 0 0 2 3 2 3 2 2 2
0  2  1  1  2  2  3  3  0  1  1  3  1  1  0  0  3  2  0  2  2  0
3 0 0 1 1 0 0 0 2 3 2 1 0 1 1 2 1 2 2 3 3 0
2  1  0  2  0  2  3  0  2  0  0  0  1  0  3  1  0  1  3  2  3  2
0023021223111121301202
2112033123120201310132
0 1 1 3 2 3 2 3 2 0 2 3 3 3 3 0 0 0 3 0 0 2
0 1 2 3 1 2 2 3 0 2 2 2 3 1 2 3 0 1 2 2 0 2
1 0 2 3 2 2 0 2 2 0 3 2 2 0 3 0 1 3 2 2 3 0
0  3  1  3  0  2  2  0  3  1  2  1  0  3  0  0  3  0  1  0  1  2
0  3  3  3  2  2  0  1  3  3  0  2  3  2  1  2  1  1  1  3  0  2
2021221123220303310002
2011101231211221200110
3301001323001032133322
0  1  3  2  1  0  2  1  3  0  2  0  2  2  1  1  1  1  2  3  3  0
1111011101110101100110
