1  0  1  1  3  1  3  1  0  1  3  3  1  0  0  0  1  0  1  3  1  0  0  0  1  0  3  0  2
02230313103103000232102111100
3  2  1  2  1  3  1  1  3  0  0  2  3  1  1  0  0  1  1  0  3  2  0  1  1  2  0  0  2
02011213311223302133303320110
0 3 0 2 1 1 0 2 2 0 2 3 0 0 3 3 2 0 2 1 3 0 1 0 3 3 2 2 0
32312322013000002101110302232
0 2 1 0 1 3 3 3 1 2 1 0 2 0 3 2 0 2 1 0 3 3 3 2 0 2 3 1 0
32120021111222330022330113332
1 1 3 3 2 1 3 3 3 0 1 0 0 3 3 1 2 1 3 1 3 1 1 0 1 1 3 2 2
12331333301212213011311211320
00123221230033310113302100130
1 0 2 3 3 0 1 1 2 2 1 1 0 0 2 0 2 3 2 1 0 0 2 2 1 2 3 3 0
1 0 2 3 0 1 3 0 2 3 0 1 3 0 2 0 3 0 3 1 2 1 0 2 1 3 3 0 2
1 1 2 1 0 2 3 2 2 3 1 3 1 1 3 2 0 1 1 2 0 1 3 3 3 2 1 1 0
1  2  2  1  2  0  3  2  1  2  2  0  3  0  0  0  0  2  2  0  0  2  0  0  2  2  1  0  0
0 3 3 2 0 2 3 1 3 1 1 1 1 2 1 1 1 1 1 2 1 2 2 2 0 0 2 1 2
12203123301032002221121223132
1 2 0 2 2 0 1 3 0 2 3 2 1 1 1 3 1 1 1 3 3 2 0 1 2 0 1 2 2
3  0  1  1  1  3  1  0  2  3  2  1  0  1  1  1  2  3  1  2  1  3  0  3  3  1  2  1  0
2 1 3 1 1 1 1 2 0 3 1 0 3 1 3 3 0 0 0 0 3 3 0 1 1 2 0 1 0
0  1  1  1  2  3  0  1  3  0  3  3  2  0  2  3  3  3  3  3  2  1  1  0  2  3  3  2  0
0 1 0 2 3 3 1 3 3 3 1 0 2 0 1 1 0 3 1 3 1 3 0 2 2 1 0 3 0
00100110221321303230202311202
2 2 2 1 2 0 3 3 1 3 3 2 1 1 1 1 3 3 2 3 0 0 1 1 0 3 2 3 2
22213031121211010113132322032
10121120323200222203120200230
3  0  2  3  2  0  0  1  3  1  0  2  0  0  2  3  3  0  1  0  2  0  0  1  3  0  2  3  2
00123200013112230200101122112
0 2 1 1 1 2 0 2 0 2 0 0 2 3 2 1 1 3 1 1 0 2 2 1 1 2 3 0 2
11101000001001100110001100000
