313310230002123133203201130120201223220
000201311031030100002021213133332123122
0 1 3 2 1 3 3 0 0 0 1 2 2 2 3 3 3 0 2 3 3 0 2 1 3 1 2 3 1 1 3 2 1 2 1 0 3 2 2
1 1 1 0 3 0 0 2 2 0 3 2 0 3 2 1 0 1 2 3 0 2 1 1 1 3 0 1 2 3 1 3 3 2 2 3 3 0 2
1  3  2  2  1  3  0  0  1  3  2  0  1  2  0  2  1  2  3  1  2  1  2  0  1  2  2  3  0  3  0  0  1  3  0  1  2  3  2
2  0  1  3  2  1  3  3  3  2  2  3  2  1  0  3  3  1  2  3  1  0  1  0  0  1  0  0  1  2  0  2  1  0  2  0  0  1  2
0  1  2  0  1  0  3  0  2  3  3  3  3  0  2  3  3  1  3  2  3  1  2  2  3  3  0  3  3  0  3  2  3  1  3  0  1  3  0
3  2  1  1  1  1  2  0  2  0  3  0  3  3  3  3  0  1  1  1  0  2  1  0  3  3  1  3  3  3  1  0  1  2  2  1  1  1  0
3  3  1  2  1  3  2  3  1  0  1  3  2  2  2  3  1  3  2  0  2  1  0  2  2  2  3  1  3  3  2  1  1  2  3  2  2  2  0
0 1 2 3 0 3 3 0 2 1 0 1 3 3 3 1 2 2 2 2 1 2 0 1 3 1 1 3 3 1 2 0 2 3 1 0 2 1 2
3  0  1  1  3  0  3  1  2  3  3  3  0  0  0  3  0  2  1  3  3  1  2  2  3  0  2  3  3  2  2  3  2  0  0  1  0  1  0
2 1 3 1 1 3 3 3 1 1 2 2 2 0 1 2 2 3 3 0 2 1 0 1 2 3 3 1 3 2 3 3 1 3 0 1 3 1 0
011211023133231123110103321203111331202
202013230110022302011001201212131020312
1  0  0  2  3  2  0  2  1  0  0  1  0  2  2  3  0  0  0  2  3  3  1  2  0  2  1  2  1  3  2  0  3  0  0  3  3  0  2
1 0 0 3 0 2 2 3 2 2 3 0 0 2 1 2 3 3 2 0 1 2 2 2 0 3 0 0 1 3 1 0 3 2 1 3 0 1 0
2 0 1 0 2 0 0 0 2 3 2 3 3 1 2 2 2 0 3 3 1 3 1 3 0 2 2 3 3 0 3 1 0 2 0 0 3 2 0
120110232001301120303102023120103202102
2 0 1 0 1 2 1 2 1 3 2 1 3 2 1 1 0 0 0 3 1 0 3 0 0 1 0 2 2 2 2 1 2 2 3 2 2 3 0
1  3  3  2  3  2  2  3  0  2  1  0  1  1  3  2  2  3  0  1  0  1  3  1  2  0  1  1  3  3  2  3  1  3  0  2  2  2  0
1  1  2  2  3  2  3  3  3  0  2  0  1  2  3  2  2  2  3  3  2  0  2  2  3  3  2  0  3  3  0  1  1  1  1  2  3  2  2
300321323020311220011131033203103030212
2 0 2 3 1 3 3 3 1 0 1 2 2 3 2 1 1 1 3 3 3 3 1 1 1 1 2 1 1 3 1 3 3 2 1 1 0 2 2
3 3 3 1 2 1 2 2 1 2 1 3 3 2 3 0 1 3 2 1 3 0 2 0 3 3 2 1 1 1 0 2 2 1 1 1 2 1 2
0 2 1 1 3 1 1 0 0 3 2 3 0 1 2 3 1 0 0 2 2 1 2 0 1 3 3 3 1 1 1 1 1 3 2 0 0 3 0
3  1  2  3  2  0  0  0  1  1  1  2  0  3  1  1  0  0  2  1  0  2  0  3  3  3  1  1  2  3  3  3  3  2  1  3  1  3  0
0 2 2 1 0 3 3 0 1 1 2 3 2 2 2 0 3 3 0 1 1 3 0 0 1 1 2 0 3 2 3 1 3 2 1 0 0 3 2
0 0 1 1 1 1 1 1 0 0 0 1 1 1 1 1 0 0 0 0 1 0 1 1 0 1 0 1 1 1 0 1 0 1 0 0 1 1 0
