1 1 1 3 3 2 0 2 3 3 2 2 0 1 3 1 1 0 3 0 1 0 1 3 2 0
2  3  2  0  3  0  3  0  0  1  1  1  0  1  3  3  0  0  2  2  1  2  2  3  3  2
0  0  1  1  2  2  1  0  3  3  3  3  0  1  1  2  2  0  2  3  3  0  2  0  1  0
10031203210021332130231010
3 2 3 3 2 2 3 2 3 1 1 0 2 1 3 0 1 0 0 2 0 2 2 1 2 2
1 0 2 2 1 0 0 3 1 3 2 3 3 0 2 3 2 3 1 1 2 2 0 3 1 2
1  2  3  1  0  3  3  3  0  1  1  2  0  0  0  3  3  2  2  2  1  0  3  0  1  0
2  2  2  1  0  2  1  3  0  3  2  2  0  3  1  3  3  2  0  0  0  3  1  0  1  0
3 3 3 0 3 1 3 1 2 2 3 3 0 0 1 0 0 1 3 2 2 2 1 1 2 2
33303322023212133112213330
0 2 3 1 0 3 0 2 0 2 3 3 0 2 1 0 1 2 2 1 1 1 3 2 2 2
2 0 1 1 3 0 0 3 3 1 1 2 0 2 2 2 3 2 1 0 0 3 1 2 0 0
0 3 3 3 3 2 1 1 2 0 0 0 3 0 1 1 2 2 3 1 3 0 1 3 1 2
31030332110122021233132210
2  3  0  1  2  3  2  1  2  0  3  3  0  0  1  2  1  2  0  2  1  2  1  0  0  0
2 2 2 2 1 0 0 0 3 3 3 2 3 3 2 3 0 2 3 3 2 1 2 3 3 0
01301231101233320012203300
3 1 2 1 1 2 0 3 2 1 3 3 1 3 2 0 1 1 3 2 3 2 0 1 1 0
21130012130131103131012312
0 3 0 0 1 3 2 2 2 2 3 2 1 3 2 0 1 2 2 1 3 0 2 3 0 2
1  3  1  2  0  3  0  3  2  2  0  1  0  2  3  3  0  3  3  2  1  1  3  3  2  0
32322303011001322211130310
01112332331102233210230330
33032323311023303001230112
3  2  3  0  3  0  2  2  2  2  1  1  3  2  3  3  1  2  1  0  3  3  0  1  3  0
13112010110312331101132310
0  1  0  0  1  0  0  0  0  1  0  0  0  0  1  0  0  0  1  1  0  1  0  1  1  0
