30122231203323002
0 0 0 1 2 0 0 1 1 1 1 3 1 3 0 3 0
2 1 2 0 2 3 3 2 2 0 0 2 3 0 3 0 0
0  0  0  2  0  1  1  3  3  1  0  1  0  2  0  2  0
12031013302311130
32123301103002130
02303312133130010
0 1 3 0 0 3 2 2 2 1 0 0 3 2 3 3 2
3  2  0  2  3  1  0  2  0  0  2  1  0  3  0  2  0
2 2 2 1 2 2 0 3 0 1 0 3 2 1 1 2 0
01320123331131230
2  3  1  3  3  2  1  0  3  1  0  2  0  3  0  3  0
11020303021111002
22013331322301032
3 2 0 3 2 1 0 2 3 2 0 1 1 3 1 0 2
21222130323222122
0  1  2  1  2  0  1  0  0  1  3  2  0  3  0  2  2
31212020002133002
2 2 0 1 3 3 1 2 0 3 2 3 0 2 1 3 0
1 3 3 1 2 0 1 3 1 0 2 2 0 3 0 0 2
1 0 0 0 2 1 3 2 2 1 1 3 1 1 3 0 2
21131111221200310
01100101000000110
