00122311123300312301120323312
1 0 2 0 1 3 3 3 0 3 0 1 0 0 3 1 3 3 2 1 1 0 2 1 3 3 1 1 0
12221303333233223210203001020
3 0 0 2 0 3 1 2 3 3 3 3 1 1 3 1 2 0 3 1 3 0 2 1 2 0 0 3 2
2  2  2  3  3  2  1  0  3  2  3  2  3  0  1  0  1  3  3  1  2  3  3  2  3  3  3  0  0
0 3 2 1 2 1 3 1 1 3 2 2 1 3 2 2 0 1 1 2 3 3 3 1 1 1 1 0 0
33130111102212232120323130122
0  2  0  2  2  3  2  2  1  3  3  1  2  0  0  3  3  0  3  3  0  1  3  2  2  1  1  1  2
11011313333130133131102001210
0  2  3  0  0  0  1  0  2  0  3  3  1  0  2  0  3  2  2  2  2  2  2  2  3  0  3  2  0
32110110321303223110210012102
13011222333121011013131230332
1  0  3  1  1  3  3  2  3  1  0  1  3  2  0  0  2  2  0  2  3  3  2  1  0  1  0  3  0
03231310320230123010132032332
22232213132003102100111203022
0 3 2 3 1 2 0 2 2 1 0 3 0 3 0 2 1 3 3 3 2 1 1 2 2 3 0 0 2
3 1 3 2 3 2 3 1 1 3 3 2 1 0 0 3 1 0 2 2 1 3 2 3 1 1 3 0 2
3 2 2 1 3 2 3 0 3 0 1 3 0 2 3 2 0 0 1 2 1 1 1 2 3 0 0 2 0
0  1  2  3  2  3  0  1  3  0  2  0  1  1  2  2  0  2  3  0  2  1  1  3  2  0  1  2  0
2  1  0  1  1  1  1  1  1  1  2  1  2  3  3  3  2  0  0  1  1  2  1  2  0  2  3  2  2
32012222212103033333232303212
0  2  1  2  3  2  1  0  1  2  0  3  1  1  1  0  2  1  0  2  0  3  3  1  3  2  0  0  0
0  3  0  0  3  3  3  0  3  2  0  1  1  0  1  3  2  2  0  1  3  3  0  0  0  0  0  2  0
0  3  0  0  0  0  0  1  0  0  1  3  3  0  2  1  3  0  1  0  2  1  0  1  1  0  2  1  0
0  1  3  2  2  3  2  1  1  2  2  2  2  1  2  0  1  1  3  1  0  0  2  3  0  2  1  3  2
0 0 1 1 0 0 0 1 1 1 1 0 0 0 1 1 0 1 0 0 0 1 1 0 0 0 1 0 0
