0 0 0 0 3 2 2 0 3 0
2 0 2 1 1 3 3 2 0 2
3  3  3  1  1  1  0  2  0  0
2  3  2  1  3  0  1  2  3  2
3  0  0  2  0  2  3  3  1  2
1233310330
2 2 1 2 1 1 2 3 3 0
2 2 1 0 3 1 3 2 3 0
2 0 0 2 3 2 2 1 0 2
2323203300
1  1  3  0  0  2  2  3  3  2
0 0 1 2 3 0 1 3 3 2
2 3 2 0 3 3 3 3 1 0
0  3  0  0  0  3  2  2  0  0
0  3  0  0  2  1  1  0  1  2
3331002002
2 1 3 3 3 3 0 0 2 2
0322211212
1 2 3 1 1 1 1 3 3 0
3323132102
3 1 1 0 3 2 0 1 1 0
3  3  2  2  3  0  0  2  2  2
2  0  0  0  1  3  2  2  3  0
3 2 1 2 3 2 0 1 1 2
3 1 1 1 2 0 0 2 0 2
0033133002
3 3 2 2 2 3 2 3 2 0
1  1  0  0  0  1  0  1  1  0
