3  0  0  3  3  2  3  0  0  2  3  3  0  2  0  1  2  1  0  3  1  0  3  3  1  0
2 0 3 1 3 3 3 2 3 1 0 1 2 0 1 1 1 0 3 1 1 0 3 1 1 2
1  0  2  3  1  3  3  2  2  2  3  3  3  0  3  2  1  2  1  1  2  0  3  1  1  0
2 2 3 2 3 2 0 0 1 0 2 3 1 0 1 3 2 2 3 3 1 3 1 3 1 0
2  0  3  0  0  0  1  2  2  3  3  2  0  0  1  0  2  1  3  3  1  0  3  2  3  0
10233301302311113020333010
03200132231232300022203130
1  0  3  2  3  0  2  3  3  3  3  2  2  1  3  1  2  3  3  2  2  2  3  0  3  2
11201300300310111002322020
3 2 1 1 0 3 0 1 3 2 2 0 0 1 1 1 3 1 2 2 2 3 3 0 2 2
3 0 2 1 1 2 1 3 0 3 2 3 3 2 0 3 3 2 3 2 1 1 3 2 1 2
3 3 0 0 3 1 0 3 2 3 3 0 2 2 0 1 2 2 0 2 0 3 3 0 2 2
3  3  1  3  0  3  2  1  0  0  0  1  0  0  1  1  0  0  3  3  0  1  2  3  1  0
20132102312002311013100332
23032233212120331203000222
21202230112232022201103300
2  1  3  2  3  0  2  3  3  0  3  0  2  2  2  1  2  0  2  2  2  1  3  0  3  0
00111233013132102311313230
2 1 1 1 2 1 0 3 1 3 3 3 1 2 3 3 0 0 0 2 0 2 0 1 1 0
2 1 3 0 2 1 0 2 0 0 1 0 1 3 2 3 0 1 3 1 1 1 0 0 3 0
23120300110233333230330202
31033230103310233120002022
30000222003301033322331112
20200223103300220230313330
01200103221032300133312130
0 0 0 1 0 1 1 0 0 0 1 1 1 0 0 0 1 0 0 1 0 0 1 0 0 0
