01300033133110133121212320103200
3 3 1 3 2 1 2 1 2 2 0 2 1 0 0 0 1 0 3 1 1 1 2 2 0 0 2 0 3 2 3 2
03111231212030020320323221123200
02110012122010310121001023201120
1 3 0 3 2 2 2 0 3 3 3 3 0 3 0 1 0 1 2 2 3 3 2 0 2 2 0 2 3 1 3 0
2 3 1 3 0 3 1 1 3 0 3 3 0 0 0 3 1 2 3 0 2 3 3 3 3 3 1 2 2 1 3 2
3  3  1  2  0  0  1  0  1  0  3  2  0  1  1  3  0  2  0  3  3  3  1  1  2  1  1  2  3  0  2  2
32301321332202032211023001320220
00001203332300211311021023330020
0 2 0 1 1 1 3 2 0 1 3 0 2 3 1 3 2 0 3 3 2 3 3 2 2 2 0 3 0 0 1 2
32221020232223200320010232011330
0 1 3 2 3 1 0 0 3 0 2 2 1 3 1 0 0 0 2 3 0 0 2 0 1 3 3 1 0 1 2 2
0 2 1 2 0 3 1 1 3 0 1 3 1 3 0 1 1 0 3 3 2 1 0 2 1 0 2 1 3 2 2 0
2  3  1  1  3  0  2  3  3  1  3  0  0  3  0  1  0  3  0  0  2  0  0  3  3  2  2  2  3  3  1  0
0 3 0 0 3 0 0 0 2 3 1 0 3 1 1 3 3 0 3 3 2 3 2 1 0 2 0 3 1 0 2 2
0 1 0 1 0 1 1 3 1 3 1 1 1 2 2 3 2 1 0 1 1 1 1 0 1 1 2 1 1 2 1 2
2  0  3  3  1  2  0  3  0  3  1  1  0  3  1  1  3  3  0  3  1  0  2  0  1  2  1  1  1  1  0  0
32031201222023301121221310130222
1  2  3  1  1  0  3  0  2  3  0  0  0  0  0  0  0  0  2  3  0  1  3  3  3  1  1  0  0  2  1  2
0  3  3  2  1  1  2  1  1  2  3  0  0  2  1  0  2  0  2  2  3  0  2  0  2  2  2  2  2  1  3  2
1 0 3 1 2 2 3 0 1 3 0 2 3 1 3 2 1 2 1 0 3 1 0 3 0 2 1 2 3 1 2 2
01323222123311000321022113132202
32022233210011113201122033212332
31332113100320022220320300033100
01100010100111001000001110010010
