2 3 0 2 1 1 3 1 0 2 1 3 0 0 2 1 2 3 3 1 2 0 0 3 2 3 2 2 1 0 1 1 1 1 2 0 2 3 0 2 2
1  1  3  0  0  2  1  1  1  1  0  0  1  0  1  1  3  2  3  1  0  2  0  2  3  1  3  3  3  0  2  2  0  2  1  3  2  0  0  2  2
1  0  3  1  3  3  3  2  3  2  0  2  3  2  0  2  0  3  3  0  0  3  1  2  0  2  0  2  1  0  0  2  0  1  3  3  1  1  2  3  2
3  3  2  0  3  2  3  0  2  0  3  3  1  1  3  0  3  0  0  0  1  3  3  2  1  3  2  2  0  3  0  3  1  3  0  0  0  0  0  3  0
3  0  3  1  0  1  3  0  3  1  0  2  0  1  2  3  0  0  1  0  2  3  0  1  2  2  2  1  2  0  2  1  1  0  2  2  1  1  3  1  0
3 3 2 2 3 1 0 1 1 3 3 2 0 0 3 1 2 2 2 3 1 1 3 1 2 1 2 3 0 0 2 3 0 1 2 3 3 2 0 1 2
1  3  2  2  3  2  3  1  3  3  0  3  1  0  0  2  0  0  0  1  3  3  2  1  3  3  3  2  2  0  3  2  3  0  3  0  1  0  0  1  0
03203121211101330000203232230030323012332
11103003312331300113132002112111111033230
01233121021310022322322213012021212303002
0  1  2  3  1  2  1  1  0  2  1  3  3  1  3  1  0  0  2  2  3  1  1  2  1  1  3  0  3  3  1  1  0  2  3  0  2  2  3  3  2
3  2  2  1  2  2  3  1  2  2  0  3  0  1  2  0  3  3  3  3  1  2  0  3  3  1  1  2  3  0  1  3  3  3  1  3  2  2  3  3  2
2  0  1  3  0  0  1  0  1  2  1  0  3  1  0  2  1  0  0  0  3  1  2  2  2  3  2  3  1  0  2  1  0  1  1  2  2  1  3  3  2
12023312030310121223032220033320111202222
1  0  2  2  1  1  1  3  2  1  3  0  3  2  2  1  3  0  3  0  0  0  3  1  0  0  1  3  3  3  0  0  0  2  0  0  2  1  0  1  0
3  2  3  0  0  0  3  2  3  0  3  2  3  2  3  1  2  1  3  0  1  3  1  2  3  0  1  0  1  3  2  1  0  2  0  2  2  2  3  1  0
2  0  1  0  2  1  3  0  2  2  0  3  2  2  3  2  3  2  2  0  1  1  1  3  0  0  1  1  2  1  0  0  0  3  3  3  1  2  1  0  0
2 0 2 3 3 0 3 0 2 3 0 0 3 3 2 3 3 1 0 3 2 3 1 1 0 2 0 2 1 3 0 2 2 2 0 0 3 2 1 3 0
0  1  0  1  1  0  1  1  0  0  1  1  0  1  1  0  0  0  0  0  0  1  0  0  1  1  0  1  0  1  0  1  1  0  0  1  1  1  0  1  0
