3 1 3 1 2 1 1 1 3 3 3 3 3 2 3 3 0 0 0 2 1 0 0 1 0 0 0 2 0 1 0 0 2 2 0
2  3  3  0  3  1  2  3  0  1  2  3  3  3  2  0  3  0  2  0  1  3  3  2  2  3  0  2  1  1  3  1  3  2  2
0 3 1 2 3 2 1 1 1 3 2 3 0 0 1 1 1 1 0 3 2 0 1 1 1 1 3 3 2 3 2 0 3 2 2
1  2  2  1  3  3  0  0  1  1  3  3  0  1  0  3  0  0  0  3  3  1  2  3  2  3  1  2  1  3  1  3  0  0  2
31320103300303130102320303333310022
02012013123130211133100333013120220
0  0  3  3  2  3  2  2  2  2  1  2  1  0  3  0  2  1  1  1  1  0  2  3  2  1  3  3  1  3  3  0  2  3  0
1 2 1 2 3 2 2 1 1 3 0 0 2 0 1 1 3 0 2 0 3 2 0 0 2 1 1 2 1 2 0 0 0 0 2
00020021000132023132321121112000012
1 3 0 2 1 3 2 2 3 2 1 0 0 3 3 2 3 3 0 1 2 0 1 0 1 1 3 0 2 2 0 0 1 3 2
3 3 1 2 3 3 2 2 0 1 2 3 2 2 3 1 1 3 2 0 1 1 1 3 3 3 1 0 2 2 0 3 0 1 0
1 1 1 3 0 1 3 1 3 3 3 3 1 2 0 2 1 3 0 0 2 1 1 3 0 1 2 0 2 3 2 0 1 1 0
3 3 1 3 1 3 3 2 0 0 3 1 2 0 3 1 2 3 3 1 0 3 2 0 1 1 2 2 1 0 0 0 2 3 0
00030213010102202101333212213301202
33010113303203111132010031231223230
02023331131030200203012303310232310
0  1  1  2  3  2  0  3  1  0  0  3  0  2  2  0  2  0  1  3  0  0  0  1  2  2  3  1  0  0  0  0  2  0  0
2 1 3 0 1 3 1 2 1 3 3 3 2 2 1 3 0 2 1 3 2 1 3 1 2 1 3 1 3 1 2 2 1 0 2
2  2  1  3  2  1  1  0  0  2  0  3  3  2  2  0  3  0  3  3  2  2  0  1  2  1  1  0  1  1  3  1  0  0  0
1  1  3  0  2  2  2  2  3  3  1  1  3  0  1  3  1  0  1  2  0  3  3  2  0  1  3  3  2  1  2  1  0  3  0
22331023202231023000201200012301302
2 3 1 2 2 3 1 3 3 0 3 0 0 1 1 3 2 2 1 3 0 1 0 1 0 3 2 1 1 1 0 3 3 3 0
1 0 2 0 2 0 2 2 1 3 3 3 3 2 3 3 0 1 0 1 2 0 0 2 2 1 1 0 2 1 2 1 1 1 2
0  1  2  0  3  3  0  1  0  1  1  0  1  2  2  3  2  0  1  2  3  0  3  3  2  3  1  1  1  3  3  3  1  3  0
0  3  3  1  2  3  0  2  3  3  1  0  2  2  2  0  1  2  3  0  0  2  3  3  2  2  0  1  0  3  0  3  0  0  0
1 3 2 2 1 0 1 2 2 3 2 3 0 1 0 0 0 2 1 0 0 2 3 1 1 0 1 1 2 1 3 3 0 1 2
0 1 0 1 0 1 1 0 0 0 1 0 1 1 1 0 1 0 0 0 0 1 0 0 1 1 0 1 1 0 1 1 1 1 0
