0 0 1 2 2 1 1 0 3 1 2 2 2 1 0 1 3 3 2 0 2 0 2 0
312320210221333221132000
022033222021320010003012
300022313133333022323032
2  1  1  0  0  3  2  2  2  3  2  0  3  2  0  1  0  1  3  1  3  3  3  2
3 0 0 3 2 2 1 1 1 1 0 1 2 1 0 1 0 0 1 1 1 2 2 0
3 2 1 2 3 0 3 2 0 1 1 0 0 1 1 0 1 3 2 2 0 3 1 2
3 0 1 3 1 3 3 1 2 0 1 0 2 3 1 1 3 2 2 3 1 0 1 2
0 0 3 1 0 3 3 2 0 1 2 0 2 3 2 3 3 2 0 0 3 1 0 2
1  2  0  1  0  2  2  1  0  0  1  0  0  2  0  3  0  1  2  3  0  0  2  0
2  1  1  1  3  0  2  0  0  1  1  2  1  1  3  2  0  1  1  1  2  3  2  2
0  1  0  0  0  3  3  1  2  3  1  0  2  3  0  0  2  2  2  0  1  3  1  0
123031222100230321222112
1 3 3 3 1 1 3 2 1 1 1 2 2 3 3 2 2 1 3 1 0 3 3 2
232132132002030011222102
320202200001200121111002
101202302301030020113130
1 3 2 3 2 3 2 3 3 0 2 0 1 1 2 1 0 1 2 3 0 0 3 2
110013101100222022012320
2 2 0 0 3 3 0 2 1 2 3 0 1 2 2 1 1 0 3 1 2 1 2 2
2 2 2 2 0 1 2 1 2 0 3 3 1 3 2 3 2 3 2 3 2 3 0 0
2 2 3 0 1 2 3 1 0 1 1 0 0 0 1 2 1 0 3 1 3 2 2 0
0  0  0  0  1  1  0  0  0  1  1  0  0  1  0  1  1  1  0  1  1  0  0  0
