000313323022322332133110002
1  1  1  3  2  2  3  1  2  0  0  3  1  2  3  2  3  1  1  0  0  1  1  2  2  2  2
2  2  1  0  0  1  0  3  2  1  2  0  1  1  3  0  3  1  0  0  1  3  2  1  2  3  0
0 3 2 1 2 1 3 2 1 1 2 2 2 3 1 1 2 3 1 2 1 0 1 0 0 2 2
1 2 1 0 3 0 2 3 3 3 0 1 2 0 2 1 3 1 0 1 3 1 3 0 3 0 2
1 3 0 0 3 1 2 3 0 1 1 3 1 0 3 2 3 2 1 2 3 1 3 1 2 0 0
3  3  1  3  2  0  2  1  1  3  2  2  2  2  3  3  0  1  3  2  0  0  3  3  3  1  0
0 1 0 3 1 1 0 0 3 3 2 2 2 0 2 3 0 2 3 1 2 3 0 3 2 2 2
3 1 1 1 1 2 1 2 0 2 3 2 0 1 3 2 2 2 0 3 0 3 2 3 2 3 0
032232310332032331222221130
123112031021013210102203300
1  0  0  2  1  2  1  3  1  3  2  1  2  3  1  0  1  3  0  0  1  3  1  0  1  0  0
3 3 0 3 1 0 3 2 1 1 0 0 3 0 0 2 1 0 2 0 3 3 0 2 2 1 0
212220002120332112000223010
033201032023231210120202000
211112101203102221221102332
1 3 3 3 2 3 3 0 2 2 1 0 0 1 1 0 2 0 0 1 2 0 1 0 0 0 0
112333313012212113102130002
202120220312312323313022232
333310001330101320012310112
1  1  2  2  1  2  3  0  0  0  0  2  0  1  3  1  0  0  2  3  0  0  1  3  3  0  0
0  2  0  3  0  0  1  0  3  2  0  3  1  1  0  1  2  3  0  2  0  2  1  1  2  1  0
0 1 1 3 1 0 1 3 2 1 0 1 0 1 1 3 2 3 3 1 0 1 3 3 2 2 2
111101010011010011001011110
