2 3 2 2 2 1 0 0 2 3 1 0 3 1 0 0 2 2 3 2
2 3 3 3 0 2 0 2 3 0 1 0 2 2 3 3 0 2 2 2
0 2 0 0 0 1 3 3 2 1 2 0 1 1 0 0 0 1 2 0
1 2 1 1 0 1 1 2 1 1 0 2 0 2 0 0 3 0 0 0
0 0 1 2 2 0 0 2 3 1 1 3 1 0 2 3 3 0 0 2
32133311001111201112
2  3  3  3  0  3  1  2  0  1  0  1  2  0  2  0  3  1  1  2
33033103300100022302
31122330333223332210
1  2  3  3  3  0  1  2  0  2  3  0  3  1  2  1  0  3  3  0
1 0 1 0 0 3 1 0 1 1 3 0 1 1 1 1 3 1 0 2
0 0 2 3 2 1 2 3 3 1 3 0 0 1 2 0 1 1 2 2
01001013003023312112
22013131103102333330
11100011110010100100
