3  1  2  2  3  2  2  2
1  0  3  1  2  0  0  0
0  3  3  3  3  1  3  2
3 0 3 1 3 3 0 2
31130202
3  1  2  2  3  2  2  2
31000222
3 3 0 2 2 2 0 0
20203330
21312300
11100010
