1  2  3  0  2  3  0  1  2  0  3  1  1  1  1  3  0
3 1 0 2 3 1 3 3 3 2 3 0 0 0 3 0 2
2  1  1  3  1  2  0  1  0  1  3  0  3  3  1  0  2
0 0 1 1 0 0 2 0 0 1 3 2 1 1 0 1 0
12222333201122230
2  3  2  3  1  1  1  2  2  1  2  0  0  3  1  0  2
01111010211211102
0  0  1  1  1  3  1  2  1  3  3  1  3  1  1  2  2
2 0 0 1 0 3 3 0 2 3 0 3 2 0 2 3 0
11020000031220132
2  1  2  2  3  3  2  0  2  2  3  3  2  1  0  1  0
2  0  1  1  0  3  1  1  1  2  2  3  3  3  2  3  2
10202113230020122
0  2  3  0  3  0  3  0  2  3  0  2  1  1  3  0  0
2 2 1 3 3 1 3 2 2 3 2 2 3 2 2 0 0
1 3 0 2 0 0 1 2 3 0 3 2 0 2 3 2 2
3  2  3  3  2  1  3  3  3  0  0  0  0  1  3  3  0
01212103131132332
2  3  1  2  1  3  2  1  0  1  2  0  3  0  0  0  0
1 1 0 3 0 0 0 0 2 3 0 3 3 2 0 1 2
30301031312131232
22112110013321120
0 2 3 3 1 0 2 2 3 0 1 2 1 3 0 3 2
1  2  2  2  3  1  2  2  0  3  3  2  3  1  3  1  2
00103321011020212
3  2  0  0  0  2  0  3  2  3  1  3  0  1  2  0  2
20110130121030122
02310210123122310
2 1 2 1 0 1 3 3 0 2 0 0 1 1 1 3 2
2 3 0 0 1 0 3 1 1 2 3 1 3 3 3 2 2
11110011101001100
