3  0  2  1  0  1  3  3  3  2  0  0  3  0  0  3  1  2  0  1  1  0  1  2  1  0  2  2  1  1  0  0  1  0  2
3 3 1 0 2 1 2 0 2 3 3 3 0 0 0 3 0 2 1 0 2 3 0 2 0 3 0 2 1 3 3 1 1 2 2
1  1  3  0  1  0  2  0  2  2  2  2  2  3  3  1  1  0  2  2  1  1  1  3  1  0  2  3  2  1  0  2  2  3  0
3 1 0 0 0 1 0 0 3 0 2 1 0 2 1 1 0 0 1 3 3 2 2 0 2 0 2 2 3 2 0 0 2 1 0
10122111202303010102302102303301122
21210110333312110000001100230232232
0  3  3  1  2  0  2  3  0  0  1  1  2  3  0  2  0  3  0  2  0  3  2  1  1  3  2  2  0  3  3  0  1  3  2
21323110013123103333302203222230120
3 2 1 2 1 0 0 1 0 3 3 1 0 0 1 3 3 3 0 3 2 3 2 2 0 0 0 2 2 0 1 2 3 3 2
3  1  3  0  2  1  0  2  0  2  2  3  0  0  1  0  3  0  2  2  2  3  3  1  1  0  0  2  3  1  2  2  1  0  2
3 1 1 2 3 2 2 3 3 2 2 1 3 2 0 0 3 0 1 3 1 3 3 0 0 2 3 2 1 2 3 3 1 0 0
1 1 0 0 2 2 3 0 2 0 2 1 1 0 0 3 0 1 3 3 1 1 2 1 3 1 3 3 0 3 2 3 2 3 0
2 0 1 1 1 3 3 0 0 1 3 0 3 0 1 3 1 0 3 3 1 0 2 2 0 2 2 3 0 1 2 0 0 1 0
1 0 3 2 2 0 1 0 3 0 0 1 1 0 3 0 1 2 3 3 2 3 0 1 3 3 2 3 0 2 1 1 3 0 0
0  1  0  3  3  1  3  0  1  1  0  1  2  3  3  0  0  0  3  2  2  1  1  2  2  2  2  2  2  3  3  2  3  2  0
10022323002231233110000320230100222
3 2 2 1 1 2 0 1 0 3 2 1 2 0 0 1 3 0 0 0 3 1 2 2 2 2 0 3 1 0 2 0 3 2 2
23012302112003203131110211033322222
33102103100213011312311121011021010
1 0 3 1 1 3 0 1 3 2 2 2 3 0 1 1 0 0 2 0 3 3 1 1 3 2 1 3 1 0 2 0 2 3 2
2 3 3 3 0 3 0 3 1 0 3 0 1 1 3 0 0 3 1 3 1 2 2 2 3 0 0 0 0 1 3 0 1 0 0
13321201232023302002020032021233332
21133011211213112202213322212023320
33002303012120023212131133312013312
10203031321313010212200102002321302
1  2  3  1  2  3  3  1  2  3  3  3  2  2  0  1  1  0  3  3  0  1  1  0  1  0  1  2  0  3  3  3  1  1  2
0  2  3  1  2  0  0  0  2  0  2  3  0  2  2  3  0  3  3  3  0  2  0  1  3  0  2  0  1  3  2  1  2  2  0
03133103230322021012010102031021230
3  1  0  0  1  0  0  3  1  0  3  2  2  3  2  0  3  2  2  1  1  0  2  1  0  1  1  1  1  2  3  1  0  2  2
1 0 0 0 1 0 0 0 1 0 1 0 0 0 0 0 1 0 1 1 1 0 1 1 0 0 1 0 1 1 1 0 1 0 0
