0 0 0 1 0 2 0 0 1 3 2
0 3 0 2 2 3 2 3 3 0 0
2 0 0 1 0 1 0 0 0 1 0
1  2  1  0  0  2  2  0  0  3  2
3  1  3  2  1  1  2  1  0  0  0
0 2 3 1 2 0 0 2 1 1 0
0 0 0 3 2 2 1 0 3 3 0
3  2  1  0  1  3  2  1  2  0  0
3 2 0 3 3 0 3 2 3 1 0
32230220022
3 2 1 0 0 0 1 3 2 3 2
20212330012
3  3  1  0  2  2  1  0  3  1  2
32132120222
32302232000
1  0  2  3  2  1  2  0  1  1  2
1  1  3  2  1  1  0  1  1  2  0
12221212022
11312110322
12220020210
0 3 3 3 2 2 2 2 2 2 0
0  1  1  1  0  1  1  1  0  0  0
