1020113202312231201302
3303112232312002120232
1  3  3  3  0  1  3  1  1  1  0  0  3  1  2  2  2  3  3  0  2  2
3  2  3  1  0  3  1  1  1  0  1  2  2  2  3  3  0  2  2  1  0  0
1 0 2 0 2 3 3 1 0 0 3 1 0 1 0 0 1 2 2 0 0 0
3320111122221320222030
0 3 2 1 0 3 0 2 0 1 2 0 2 2 2 1 3 2 0 3 1 0
3  2  1  0  2  3  1  1  3  0  1  1  0  2  3  0  1  0  0  2  1  0
1 3 3 0 0 0 2 0 0 3 2 2 0 0 0 0 2 1 3 0 2 0
1203233102120233011030
3  2  2  1  0  0  2  3  1  1  1  3  0  0  0  2  0  1  1  0  0  0
1 0 3 1 2 2 0 1 3 3 0 0 3 3 1 1 3 0 2 3 3 2
2  3  3  0  1  1  2  2  1  1  1  2  1  3  0  0  0  1  3  1  3  2
1103233132221301131002
3330020310310003022322
0 2 3 2 0 2 2 0 1 1 2 3 2 0 1 1 2 2 2 0 3 2
3311002323013003022102
3  0  3  2  2  2  3  1  2  0  2  3  3  3  2  2  1  0  3  1  3  0
3  1  1  3  2  2  3  3  2  1  0  0  2  0  2  0  0  1  2  2  3  0
0 1 3 1 2 1 1 2 2 2 0 1 1 2 0 3 0 0 3 2 1 0
0  2  3  0  3  2  0  2  2  0  2  2  0  0  0  2  2  1  2  1  3  2
0  2  1  0  1  3  0  2  1  3  0  2  3  0  1  0  0  1  1  3  2  2
1  2  3  0  2  1  3  3  0  0  0  2  2  0  3  1  2  0  3  1  1  2
1132010311132213212032
0 3 2 2 1 3 1 3 3 3 1 1 1 2 2 2 2 1 0 1 3 2
0 1 0 0 1 0 1 0 1 1 0 1 0 1 1 1 0 1 1 0 1 0
