0 3 0 3 2 2 3 0 0 3 2 2
223210211112
3  1  1  1  0  1  0  2  3  1  1  2
103100000120
1  1  1  2  0  1  3  2  2  2  1  0
0  2  2  3  2  2  3  1  0  3  2  2
123100110322
320311323030
0  2  0  0  2  1  2  2  1  0  3  2
0  1  3  1  1  2  2  3  3  3  1  2
1 3 2 0 3 1 2 0 0 1 0 2
2  0  1  3  1  2  3  3  1  1  1  0
231130231112
0  2  2  0  2  1  1  0  1  0  1  0
122033302132
2  1  2  0  2  1  3  1  1  1  1  0
110020301130
2 3 2 0 3 3 1 1 1 0 0 2
1  1  3  1  0  3  3  0  0  1  1  0
1  1  1  1  0  0  1  2  1  2  0  0
3 3 3 0 0 2 1 0 3 1 3 0
011121032110
1  3  0  0  3  1  3  0  0  3  1  0
2  1  2  1  1  3  1  1  2  2  2  2
0 1 0 0 2 3 2 0 0 3 0 0
302211132222
0  3  1  3  2  3  1  0  3  0  2  2
111120222002
0  3  2  3  0  0  1  3  3  1  2  0
1 0 0 1 0 1 0 1 0 0 1 0
