1  0  1  0  0  0  3  1  3  0  2  2  1  3  3  3  2  2  2  2  0  0  1  2  2  1  2  1  2
32111102121121003223200301030
21022330000133222130312122232
3  3  1  0  3  0  3  2  3  1  2  3  0  3  0  1  3  1  2  3  2  3  1  1  3  2  1  0  0
3 1 1 3 3 3 0 1 0 1 1 1 3 0 1 1 3 3 1 3 2 1 2 2 1 3 0 3 2
3  0  0  0  1  0  2  1  1  0  1  1  1  0  2  3  2  2  0  2  1  3  3  2  2  3  0  1  2
3  3  0  1  0  2  1  3  3  0  1  0  2  1  1  2  3  2  2  3  3  2  3  3  0  3  3  2  2
3 2 3 1 2 3 0 1 1 3 2 2 2 1 1 3 2 3 3 0 3 3 3 3 2 1 2 0 2
3 2 0 0 3 2 0 2 1 1 0 2 1 0 3 0 0 3 0 0 0 1 0 3 1 2 0 2 0
3  1  3  0  1  2  3  1  0  2  0  2  1  1  3  2  0  0  0  3  0  1  0  2  3  1  1  2  0
1  0  0  2  1  1  3  0  3  3  0  1  1  1  1  0  1  3  1  1  2  3  0  1  3  2  1  0  0
3 0 1 3 3 1 1 3 2 3 3 0 2 0 0 1 3 1 2 0 2 2 2 3 1 0 0 3 2
00202223102230033031303002220
2  0  0  2  2  0  1  2  0  0  3  0  2  1  0  0  2  0  3  1  3  3  3  2  2  3  1  0  0
13010120020122013011213033132
2  3  3  1  0  1  1  1  0  2  3  3  1  1  2  3  1  3  2  1  1  2  0  0  2  0  1  1  2
01320231332301230300223313330
03211120011012012313300011220
1  0  1  0  0  0  0  0  1  0  1  0  1  0  0  1  1  0  1  0  1  1  1  1  0  1  1  1  0
