0 1 2 2 3 1 2 1 1 0 3 1 3 2 2 2 0 1 3 1 2 3 0
0  1  3  2  0  3  2  2  2  0  3  0  3  2  3  1  0  0  0  0  1  3  0
00223212301321010212112
0 0 0 2 3 2 3 2 3 2 3 2 0 0 2 2 3 1 1 2 2 1 0
0  0  3  2  2  3  3  1  1  3  3  2  0  0  2  0  3  1  3  3  2  2  0
1  3  0  2  0  0  3  3  0  3  2  3  2  1  0  3  3  2  3  3  3  1  0
23110010233221332003100
1  2  1  0  3  1  0  2  3  0  1  0  0  2  3  2  3  3  0  0  1  0  0
00233211032320201203312
11111011223132001321222
00000100110011001011110
