0  2  0  0  0  2  1  1  2  1  3  1  1  0  2  0  0  3  0  3  0  1  0  3  0  3  1  3  2  0  3  1  2  2  3  3  0  0
22302033212113132010211130002020303200
1 3 2 2 0 2 1 3 0 2 1 1 0 2 2 3 3 1 0 1 2 2 0 3 3 0 0 2 1 0 3 2 0 1 3 0 1 0
03010233223001203210323333213303002332
30313213201130321233133101102101112010
3 3 2 2 2 2 0 2 3 2 0 3 0 0 1 2 1 2 3 3 2 0 1 0 1 2 1 3 2 2 3 2 2 2 1 1 2 0
31032100001231023002102102012100313310
2 1 2 2 1 0 2 3 3 1 1 1 0 0 3 2 0 3 2 3 1 0 3 2 0 0 2 2 3 2 1 2 0 2 0 1 3 0
31330212002223133021300213131111213202
1  0  1  1  3  1  1  0  2  3  3  0  3  2  2  1  1  2  1  1  1  1  2  2  1  0  1  0  3  3  0  1  3  0  0  0  3  2
3 3 1 1 3 2 3 0 2 0 3 2 0 0 2 0 3 1 1 0 2 2 1 0 0 0 3 1 3 3 2 0 0 1 1 1 1 2
00121100130132013021021332220101311112
2 3 1 2 0 1 2 2 0 3 1 1 3 3 1 3 0 0 2 0 2 3 3 1 1 1 3 0 3 2 3 0 2 3 2 2 2 0
13211303331230233110103012310231212310
23310310122303301213212112031231100230
2 3 3 2 3 2 3 1 3 1 3 2 3 0 2 1 3 1 0 1 0 0 1 0 2 3 1 3 3 1 0 2 2 1 2 2 3 0
12233113103010032112320031133113021112
1  3  3  0  2  3  0  1  0  2  2  3  1  1  1  0  0  1  0  1  2  2  0  0  2  3  3  0  3  0  3  2  1  0  3  1  1  2
3  1  2  0  1  1  3  1  3  1  0  1  2  3  1  3  1  2  1  1  0  0  1  3  3  2  3  1  3  1  1  2  2  1  3  2  3  0
1 0 0 2 1 3 1 3 3 0 1 3 0 2 2 1 2 3 0 2 3 1 2 0 2 1 2 2 3 2 1 1 1 3 0 3 0 2
1  2  3  1  2  3  3  3  0  1  2  1  3  2  3  2  1  2  1  2  0  1  2  3  3  0  1  0  2  0  3  2  2  2  1  2  3  2
2  3  3  1  0  3  3  1  3  0  2  1  0  2  2  3  0  3  1  0  3  0  1  3  0  1  2  0  2  1  0  2  2  2  3  1  0  2
1  3  1  0  0  1  2  3  1  0  1  3  3  0  2  3  3  0  3  1  1  0  3  2  2  0  2  2  0  3  3  2  0  1  1  3  3  2
12231222223030302231133220200300323110
03130030302013123000210001002002223012
3  3  3  2  3  2  3  2  3  3  3  0  3  2  2  3  0  0  1  1  0  2  2  0  3  3  2  0  2  1  2  3  3  1  2  2  2  0
02102203320200120021010002333031201212
3  3  3  1  2  2  3  0  3  1  3  1  3  0  3  3  3  1  0  3  0  2  3  3  1  3  0  1  1  2  0  1  3  0  0  1  1  2
3 2 2 2 0 2 0 2 2 1 3 1 3 1 3 3 3 3 0 1 3 2 2 3 3 0 3 3 1 2 1 0 3 1 0 2 1 2
1  0  3  2  2  0  0  3  0  2  2  1  2  0  2  2  3  3  0  0  3  1  3  3  2  3  0  1  2  3  0  2  3  2  0  2  1  0
1  1  0  0  1  0  1  1  0  1  0  0  0  1  1  1  0  1  1  0  1  0  1  0  0  0  0  1  0  1  0  0  1  0  0  1  0  0
