3  3  3  3  1  3  3  1  2  3  0  1  1  0  3  1  2  0  3  2  2  0  2  1  0  0  0  2  1  2  0  2  2  3  2  0
230111221013002322022000001132312130
2 0 3 3 3 2 0 2 1 2 2 1 2 1 3 0 2 0 2 3 3 0 1 1 1 0 0 1 3 0 0 2 0 0 1 2
1 1 1 0 0 2 2 2 0 3 2 2 1 0 0 3 0 0 3 3 0 3 2 2 2 3 2 1 1 2 2 2 0 3 0 2
3 1 1 3 2 2 1 3 3 3 3 1 2 0 0 2 1 2 2 1 2 0 2 1 3 1 0 3 3 1 0 1 0 1 0 2
1  3  0  2  0  1  3  2  1  2  2  0  3  0  3  0  0  2  3  3  0  3  3  1  2  0  0  0  3  1  3  1  0  1  3  2
021230332131031011223020313222030200
2  2  1  2  2  1  0  3  3  2  1  2  2  1  3  0  2  2  3  1  2  3  0  3  1  1  2  1  2  0  2  2  2  3  0  0
033003210022222211231321101230001222
0 1 2 1 0 2 2 2 0 0 1 0 1 0 3 3 1 1 0 2 2 3 2 0 0 0 1 0 3 0 2 3 0 2 3 2
3  1  2  3  2  1  3  2  0  1  3  0  3  1  2  3  1  1  0  2  3  2  3  1  2  1  3  2  0  1  0  2  3  3  2  2
3 3 2 3 1 2 1 1 1 0 0 0 2 1 2 1 3 0 1 0 2 0 1 1 3 3 1 2 0 1 3 1 3 1 0 2
1 3 0 0 0 0 0 3 2 3 3 3 0 0 0 2 0 0 0 0 2 3 2 2 3 0 3 0 0 3 1 3 2 3 0 0
031011013003102101010233010103121132
1  3  3  0  2  2  2  0  1  3  2  1  0  2  1  0  2  3  0  1  2  3  1  3  2  3  1  2  0  2  0  0  1  0  3  2
1 3 0 0 2 3 0 3 1 0 2 2 3 0 2 3 3 0 2 3 3 2 3 1 0 2 2 3 2 1 2 1 1 2 2 2
123113121022220200120331212022232002
330133222023301112211011332323011330
3 0 3 1 3 3 2 1 2 1 3 1 0 1 0 0 2 1 1 1 2 0 1 1 3 0 0 1 3 0 1 3 0 2 3 0
110211003323021101301121303132232220
1 1 3 0 0 0 2 1 3 1 3 2 2 1 3 0 0 1 0 2 0 0 1 0 0 1 1 0 3 1 2 2 3 2 1 2
0 1 3 0 2 0 1 0 1 0 0 2 3 1 3 3 2 0 2 2 1 3 0 3 0 2 3 2 1 3 1 1 0 0 2 0
011222021110232331210312003032233302
320213311201321311302300012221233030
0 3 2 1 2 2 0 1 3 1 0 2 1 3 2 1 2 1 1 1 3 1 2 3 2 3 2 1 0 1 3 1 0 3 3 0
1 1 1 0 1 0 0 0 1 0 1 0 1 0 0 1 0 1 1 1 1 0 1 0 1 0 0 0 1 0 1 1 0 0 1 0
