3 3 1 1 3 1 2 2 2 2 1 0 3 0 3 0 2 0 2 2 2 0 1 2 0 0 0 0 1 1 0 1 2 3 3 2
3  1  2  0  3  1  2  1  1  1  2  1  2  1  2  0  3  2  0  1  3  3  2  3  2  3  0  3  3  2  1  0  3  1  0  2
313200211010010103010311022112313202
130211111020113203021103010110112202
1  3  3  3  1  1  2  0  3  1  3  0  0  0  3  2  2  2  0  2  0  2  3  0  2  3  1  1  1  3  0  3  3  0  3  2
2  2  3  1  3  2  3  1  0  1  2  2  3  3  2  2  0  2  2  2  3  3  1  0  3  1  1  0  0  1  2  2  0  0  0  2
1  0  1  0  2  3  3  1  0  1  1  2  2  2  0  0  1  3  2  3  2  0  0  0  2  1  1  2  0  2  3  3  3  0  1  0
2  1  3  3  3  2  3  0  2  2  1  1  3  2  3  1  3  0  3  0  0  2  3  2  2  2  1  3  2  3  0  3  2  0  2  0
310230232032132202113212303130320032
200220103002231021111230331301001132
3 0 3 3 0 3 2 1 2 3 1 2 0 3 1 1 0 0 3 0 3 3 1 2 3 1 0 1 1 3 1 1 3 2 2 2
202332023121101110131300311233300322
2  1  0  0  1  0  1  3  1  3  1  0  3  0  1  0  0  3  0  2  1  0  0  2  3  1  1  1  3  3  3  0  2  1  2  0
3  0  0  2  1  0  0  0  3  1  3  2  0  1  3  1  0  0  1  3  0  1  2  0  2  3  2  1  3  1  0  2  1  0  3  0
221133232013232013132332330133113220
2  2  1  1  1  0  0  1  2  0  2  2  0  0  3  2  3  2  0  2  3  2  0  2  3  3  3  2  0  1  0  2  1  2  1  0
3 2 3 2 2 0 3 1 2 2 0 2 0 3 0 2 3 0 1 0 0 2 1 1 3 0 2 0 1 0 1 0 1 1 0 2
1  0  0  3  3  1  2  2  0  3  3  2  2  1  2  2  1  1  1  0  1  3  1  1  0  3  0  2  0  3  3  2  1  1  1  2
310300313131313132220332133220200302
1  0  0  1  1  1  0  1  0  0  0  0  0  1  1  0  1  0  0  0  1  0  0  1  0  1  1  0  1  0  0  1  1  1  0  0
