003020031002022022210212020
2 0 2 0 1 2 3 1 0 0 2 1 2 2 1 3 0 1 2 0 0 0 1 2 3 2 0
300130212230103230303323230
3 0 3 1 1 3 3 3 0 2 1 2 1 2 3 2 1 2 2 2 2 3 2 2 1 3 0
2  3  0  2  1  3  2  0  0  2  2  3  1  1  2  3  2  0  2  1  2  3  0  1  2  2  2
3  0  0  0  2  0  2  0  0  0  3  3  0  1  0  3  1  2  2  0  3  0  0  1  0  3  0
303211222131020210132103012
122301022330303022011021102
0 1 2 3 1 1 0 0 2 1 3 1 1 3 1 2 3 0 0 2 2 2 2 0 0 1 0
2  2  3  3  1  2  0  3  0  2  2  1  3  1  2  0  2  3  0  0  0  3  0  1  3  1  0
211130233222231310333030230
0  1  3  0  3  2  3  1  3  3  1  3  1  0  1  0  1  1  3  2  3  3  1  1  3  3  0
3 2 2 2 1 2 3 1 0 2 2 3 1 3 2 2 3 1 1 3 1 0 1 3 1 0 2
2  2  3  1  1  1  3  1  2  2  0  2  3  0  1  3  2  1  1  3  2  1  3  1  2  2  2
311010030200130003003120332
1  2  1  0  1  3  3  2  2  2  2  0  0  3  2  3  0  1  2  2  3  0  0  1  2  1  0
2 2 2 2 1 0 0 0 0 2 0 2 2 1 1 3 0 1 3 1 2 2 2 2 3 1 2
011033132021113020032323002
030013321103121230102030122
0  3  2  3  3  3  3  1  1  1  0  2  2  1  3  2  2  0  2  1  3  0  0  3  1  2  2
1  2  3  2  3  3  3  2  0  2  0  2  3  2  0  0  2  1  2  2  1  2  2  2  3  2  0
101121232131223232312020322
3  2  2  0  0  1  2  2  0  3  1  2  0  3  3  0  2  0  3  2  1  2  2  0  3  1  0
0 2 2 1 0 0 0 3 3 3 1 0 3 2 3 2 1 0 1 1 0 1 3 0 0 0 0
110011000111110010100001000
