2 2 1 3 0 2 3 2 3 2 0 2 0 3 2 1 3 2 0 1 1 1 1 2 2
0  3  3  1  3  0  0  2  3  2  2  3  3  2  1  3  2  0  0  1  0  3  2  0  2
2032232112013123331103012
1 0 3 0 0 2 1 3 1 0 1 2 3 1 2 2 2 1 0 0 3 1 2 1 0
0 0 2 2 1 0 1 2 1 3 1 1 0 3 1 2 2 2 3 3 1 1 0 1 0
0 0 3 3 2 1 0 2 2 1 3 3 1 0 1 2 2 0 0 3 1 0 3 2 2
1 2 0 3 1 3 2 2 1 0 2 3 2 0 2 0 2 0 2 0 0 3 1 2 0
2 0 1 1 2 2 2 2 1 1 2 2 0 2 0 3 3 1 2 1 3 3 2 3 2
3122020102103331333003020
2  2  0  2  2  2  0  0  1  0  0  1  1  0  0  3  3  0  3  3  3  3  3  2  2
3122310303010000210202312
0230023011111000220120120
0 2 1 1 3 0 0 1 3 1 1 2 2 3 2 2 1 1 3 3 2 2 0 1 0
1 1 2 2 2 1 0 3 0 3 0 0 2 0 2 1 1 1 1 0 1 3 2 0 0
2  1  2  2  0  3  1  2  3  2  0  0  2  0  3  0  2  3  2  3  1  2  1  1  0
1312331132200330212201300
1032010333300231320123020
3 2 2 0 0 1 0 3 1 2 0 1 3 2 2 0 0 2 3 2 2 0 2 0 2
3 3 3 0 0 1 2 3 0 1 0 1 2 1 2 0 3 2 0 0 1 0 3 1 2
0  0  3  1  3  3  0  0  0  0  2  2  1  0  2  2  1  1  3  3  2  2  0  3  2
0030111300222320220332002
0 2 0 2 3 3 0 3 3 2 3 2 0 1 1 1 0 2 2 2 0 2 0 0 0
1 1 0 2 2 1 2 0 3 1 1 2 0 3 2 0 2 3 3 1 1 0 2 2 2
0130022002132032223321120
1221021022203110223112222
3322303011313012032213212
1  1  1  0  1  0  0  1  1  1  0  0  0  1  0  1  1  0  0  1  0  0  1  0  0
