2200001303103320
1 3 3 0 1 2 0 3 0 1 2 1 0 3 1 2
3 0 3 1 2 2 0 1 2 0 3 2 3 1 2 0
0  2  1  0  3  2  0  0  1  0  3  0  2  2  3  0
3 2 0 1 1 1 0 1 3 1 1 3 1 2 0 2
3232131323003332
0  3  2  3  0  1  3  3  2  1  1  0  0  1  3  0
3  1  2  0  0  0  3  1  3  3  3  0  3  3  2  0
2  3  1  0  0  0  3  1  2  0  2  1  2  0  3  0
0 1 1 3 2 1 1 0 3 3 2 3 0 2 0 2
1000333002212010
1203122103013110
2213332013221020
0112003000232000
2  2  3  0  1  2  0  2  2  0  1  1  1  0  1  2
0 0 0 3 2 0 1 2 2 0 0 3 1 1 1 2
1030222312222002
1 0 1 2 2 2 3 0 2 0 1 0 2 2 3 2
0 0 0 2 1 3 0 3 0 0 0 1 3 2 1 0
2100101032233132
0  3  0  2  3  3  1  0  1  0  2  3  3  3  0  0
3 1 1 2 2 1 1 3 2 3 3 1 0 1 1 2
2  3  2  1  1  0  0  0  2  0  2  0  2  0  0  2
2311232023012122
3  3  0  0  0  0  3  2  1  2  3  0  2  1  3  0
3330202330212320
3 0 2 1 0 3 0 0 0 2 0 2 0 3 0 2
2  1  1  2  0  0  3  1  1  0  2  0  2  1  1  0
0  1  0  1  0  0  1  1  1  0  1  0  1  0  1  0
