3 2 3 0 3 0 2 0 1 1 0 2 0 2 1 1 2 1 2 2 1 0 0 1 3 3 2 1 0 1 0 0 2
1  0  2  1  2  2  3  1  2  3  2  3  0  2  1  0  1  3  3  1  2  2  1  3  0  1  2  1  2  2  0  0  2
3 1 2 0 1 3 2 2 2 0 1 1 3 2 1 3 0 2 1 2 2 2 3 1 1 0 2 3 1 2 3 3 2
211133030133002033011200320102300
2 3 1 3 3 3 0 3 3 3 3 0 3 1 0 0 0 1 3 0 2 3 2 2 3 2 2 2 2 1 0 0 0
2  3  0  2  3  1  2  3  3  2  3  1  0  2  3  0  3  0  0  2  1  2  1  3  0  2  2  1  3  3  2  2  2
0  0  2  3  0  1  1  1  0  3  1  0  2  2  0  3  1  2  1  2  0  1  1  0  0  0  2  0  1  0  1  0  2
3 3 1 2 1 3 0 0 2 0 2 1 2 3 0 2 3 0 3 3 2 2 3 1 3 2 2 1 1 2 0 1 2
1 2 3 3 3 0 3 0 1 0 3 2 1 0 0 3 3 1 1 3 1 0 1 3 3 3 2 3 1 3 3 2 2
001201031330311303201313221220200
3  0  1  1  0  0  2  3  1  0  0  3  1  1  3  3  3  2  1  0  3  1  2  0  3  1  0  2  1  2  0  0  2
0  2  3  1  2  0  2  0  2  2  0  1  2  0  3  1  2  0  3  0  2  3  1  0  3  2  3  3  3  0  0  0  2
0 1 1 1 1 1 3 2 3 2 1 2 2 3 3 3 1 3 2 2 3 0 0 0 3 3 3 2 0 2 2 0 2
1 1 1 0 3 1 3 3 0 1 0 1 0 0 1 0 3 2 0 3 2 2 2 1 1 2 2 0 0 2 1 3 0
2  3  1  3  2  0  0  3  1  1  3  3  2  2  3  3  2  0  2  2  0  0  1  1  3  1  0  3  3  1  3  1  2
3 1 3 0 1 1 1 3 3 0 0 1 3 1 2 0 3 2 2 2 0 0 0 3 0 1 0 1 0 2 2 2 2
3  3  1  0  3  0  0  2  0  2  3  2  1  3  2  2  0  0  2  3  1  0  0  1  3  2  2  0  2  1  1  3  2
0 1 3 1 2 0 0 0 1 1 0 3 2 1 2 2 2 3 2 0 3 0 3 2 3 2 2 2 3 1 3 2 0
1 3 2 1 0 3 2 0 0 3 3 1 3 1 1 2 2 3 1 1 2 0 0 2 1 2 2 2 2 3 0 0 0
0 3 0 3 3 0 1 0 0 1 3 1 0 3 1 1 1 2 1 2 2 1 3 1 2 3 3 0 2 3 0 1 2
3  3  3  3  1  1  0  0  0  3  2  0  0  3  1  3  2  2  0  3  2  3  0  2  0  2  2  3  0  2  0  0  0
1 2 3 0 2 1 3 2 3 0 3 2 3 3 1 0 3 2 3 1 3 1 0 1 1 2 0 2 1 3 0 1 0
322122133320230031002111321010232
211022212223031101121331001001000
012130212130302021113003220133012
3 0 1 3 2 0 1 3 1 2 2 2 3 3 3 1 2 2 1 2 0 0 2 1 1 1 3 3 2 0 1 0 2
0 2 3 1 0 1 2 1 3 2 1 3 0 3 2 0 3 0 0 3 0 1 3 0 1 0 0 0 3 3 1 3 0
100001000100100110000000011010010
