3  1  3  3  2  3  2  2  1  0  3  1  0  0  3  1  0  3  2  2  0  0  0  1  3  0  0  0  0  2  0  1  2  0
0 0 1 2 0 2 3 0 2 2 0 1 0 0 1 1 0 2 3 3 3 1 1 2 3 1 0 3 2 3 2 3 3 2
0311212133323102333003131203213202
3 2 2 0 2 1 3 3 3 0 1 2 2 1 0 1 3 3 2 2 1 2 3 0 2 3 1 3 0 2 2 2 0 0
2  1  2  3  2  1  1  3  3  1  2  0  0  3  0  1  1  3  2  1  3  2  1  1  0  2  1  0  0  2  0  3  0  2
2323123022203230213311222010021312
3 3 3 2 0 0 0 2 0 1 2 2 1 3 0 2 0 1 1 1 3 3 1 2 0 3 3 1 1 0 1 0 2 2
2 2 3 2 0 3 0 2 0 0 3 2 2 3 1 2 2 3 1 0 0 1 3 3 2 1 3 2 1 1 1 1 3 2
1  2  1  3  1  2  0  2  3  3  1  3  3  1  3  2  3  1  2  0  3  3  1  0  0  2  1  1  2  1  2  0  1  2
1  2  1  3  1  3  2  0  0  2  3  0  1  1  3  2  3  0  3  0  1  1  1  3  3  3  3  0  1  1  0  1  0  2
1111212101222310131011232023323110
1101100000110111001111111010010100
