300100132112113103032
1  3  0  0  3  2  3  3  3  0  3  1  2  0  0  3  2  1  2  0  0
210330210221131310110
2  0  2  1  1  3  2  3  1  3  3  3  2  0  0  1  2  1  2  0  0
303123303212102120032
230201102012301221310
202222013020211131200
1 1 2 0 0 2 0 3 2 2 3 2 2 3 3 3 2 0 0 2 0
1 1 1 0 1 1 3 3 0 0 3 0 3 3 1 0 2 0 2 0 2
0 3 1 0 0 3 3 1 0 3 3 3 3 0 3 2 2 2 0 0 2
1  2  2  0  0  3  3  1  0  0  2  1  1  0  2  1  3  3  0  3  0
1 3 1 0 2 0 2 1 3 3 3 1 2 2 1 2 3 0 3 3 0
3  0  2  0  0  3  1  3  1  2  1  2  1  0  1  0  0  0  2  3  0
100001001010101011100
