2001031230231220113111330231202122
3 0 0 1 1 2 2 3 0 2 0 2 0 1 3 2 1 1 1 2 2 2 0 1 1 3 1 0 2 1 2 2 2 0
0  1  2  2  3  0  0  2  3  3  0  1  2  1  1  0  2  1  2  2  1  2  1  1  2  0  0  0  3  0  0  1  3  2
3  0  3  3  3  2  2  3  1  2  3  0  0  3  0  2  3  1  0  1  1  0  3  0  2  2  3  1  0  3  2  1  1  0
3200101213100012322323011331201000
2 0 3 3 0 3 2 1 3 2 1 0 1 2 3 3 1 1 0 1 0 1 0 1 0 1 0 1 3 1 3 2 0 0
0  2  2  1  2  2  1  2  3  0  3  1  3  3  3  2  0  2  0  1  1  0  1  3  0  0  2  3  3  3  2  0  1  2
0003013113033312232130203010201302
1  1  3  0  2  2  0  1  1  0  3  2  3  3  3  3  3  2  3  2  1  2  3  1  3  2  0  1  0  2  2  2  2  2
3  0  2  3  0  3  2  3  3  3  2  1  2  3  2  1  1  2  0  3  1  2  3  0  3  3  1  1  1  2  1  3  2  2
3 1 2 3 2 1 2 3 2 2 0 3 3 1 2 0 2 0 3 2 2 2 0 2 2 2 0 0 0 1 0 3 0 2
3213212101100222203232332210132312
1023020120311322123331311103313212
3300130130321310232303113101102032
2 0 3 3 2 1 2 0 1 3 1 3 2 2 1 1 1 2 2 1 3 2 2 0 1 0 3 0 1 2 2 3 0 2
1  0  0  1  0  1  0  0  1  0  1  0  0  1  0  0  0  1  0  1  0  0  1  0  1  1  0  1  1  0  1  0  0  0
