21301203222232
1 3 2 3 1 3 2 3 2 0 2 2 1 2
03013133013222
03103300111222
00012112213330
3  1  2  0  3  1  3  0  0  1  0  1  1  0
11032231033102
1 1 0 0 3 2 0 3 2 2 3 3 3 2
3 3 3 1 1 1 2 0 0 2 3 1 0 2
33013022031322
01311221232332
22000200122030
1 3 0 2 0 1 1 1 1 2 1 1 3 2
2  1  1  1  2  2  3  1  1  3  2  0  3  2
1 2 3 1 3 0 2 3 1 3 3 3 0 0
3 0 1 2 2 1 3 0 3 2 2 0 0 0
3  3  2  1  2  1  2  3  0  2  2  0  3  2
1  3  3  3  1  1  1  3  1  3  0  0  2  2
11001031132310
23132232303230
3 0 0 2 2 1 3 1 3 1 0 3 2 0
0  1  3  0  0  1  3  2  1  3  0  0  2  2
30310022010210
2 2 2 2 2 2 3 3 1 3 3 1 3 0
31223303031132
12132103001110
3 0 2 2 1 2 2 1 1 1 3 0 2 0
10202323001222
30200222303000
23013101332122
01010101000100
