322132032
3 3 2 2 3 2 0 1 0
0 0 2 2 0 3 3 1 0
113022222
3 0 0 0 3 3 1 3 0
3  0  1  1  2  3  3  0  0
3 3 2 0 3 1 0 0 2
232322000
3  1  0  2  0  2  1  2  2
1  1  2  3  1  2  0  2  2
130002202
312323110
2  1  2  2  3  0  3  2  2
133030200
311121130
3  3  0  3  1  3  1  0  2
0 3 0 1 3 2 3 2 2
0  0  3  3  0  3  2  2  2
013320010
1 0 0 1 3 3 1 1 0
0 1 0 1 1 1 1 0 0
