133230332110203200
022331313100022220
2  1  3  1  2  2  1  3  3  0  3  3  3  0  1  0  0  0
2 0 2 0 2 3 0 1 1 2 3 3 3 3 1 0 3 0
011103102131301020
2 0 0 1 1 1 3 3 1 3 0 2 0 2 1 2 0 2
2 1 0 2 2 3 1 2 2 2 0 3 1 2 3 0 3 0
3 0 3 2 1 0 3 3 3 3 1 1 3 0 0 1 0 2
0  0  2  0  3  3  2  1  1  1  3  3  0  0  2  2  0  2
1 2 1 0 0 2 1 0 0 3 3 1 3 0 1 0 2 0
013103122330120110
021033102112121202
0 2 1 3 1 2 2 3 0 0 3 0 0 1 1 1 0 0
1 1 3 3 1 1 3 0 3 2 0 3 3 2 0 0 0 0
010101313323221102
2  2  0  2  3  2  2  0  2  2  2  0  3  0  3  3  1  2
010103212131300312
320022103331003332
233131103120303230
201320202211202220
2 2 0 2 1 2 1 0 1 2 2 2 1 2 2 2 1 2
020320322111033212
010001000101010010
