3112010023323102
0 3 0 0 3 1 3 1 3 0 3 2 1 2 2 0
2203222310332210
3  3  3  3  2  1  0  0  0  0  1  3  0  3  1  2
2112232331321200
0 0 3 2 1 0 2 3 3 2 2 3 2 2 1 2
2  3  2  0  0  2  3  0  2  3  3  2  3  2  2  0
2  1  1  1  2  2  3  0  2  0  3  2  0  2  0  2
2  1  2  3  1  0  2  0  3  3  3  2  0  2  2  2
0  1  1  3  2  3  2  2  3  2  3  1  3  2  2  2
2303301010313130
1  3  2  1  3  3  2  0  3  0  2  3  2  1  2  0
0 0 1 0 0 1 1 3 2 2 3 1 2 0 3 2
2220210301103220
3  0  1  2  0  2  3  2  0  1  0  3  0  2  0  2
1  2  2  3  1  1  2  3  0  1  2  3  1  1  3  0
1  0  2  1  2  0  0  2  1  3  3  2  2  1  2  2
3 0 1 3 2 2 0 1 0 2 0 1 0 0 0 0
2  2  1  1  1  0  1  3  2  0  2  2  1  0  3  0
1223012113213330
2212231310100202
0  0  3  2  3  2  1  3  3  3  1  0  3  0  2  0
2212232003303132
2  0  3  2  3  0  1  3  0  3  1  0  1  1  1  2
0110101010111110
