0  3  3  2  1  1  3  1  2  3  1  0  0  2  3  3  2  3  1  1  3  2  3  1  3  2  3  2
1022131203000012322200323232
0  1  0  2  1  2  3  3  1  3  0  2  0  1  2  3  2  1  2  3  1  1  0  0  3  3  0  0
1333223311201233322103213100
3 1 0 0 3 0 0 1 1 0 0 3 1 3 2 2 0 3 0 3 1 2 0 1 3 0 0 2
2 2 3 2 2 2 1 1 1 2 0 2 3 1 2 2 3 1 0 0 0 3 2 2 3 3 1 0
0122222302121013032200302300
3122202012121003011133300102
3  2  0  0  1  3  0  2  1  0  0  1  0  0  0  2  3  2  0  0  1  1  2  3  2  3  0  2
2 1 0 3 0 2 3 0 3 1 3 0 0 0 1 1 0 0 1 3 3 0 0 0 1 3 3 2
1  2  3  0  3  2  3  0  2  0  3  3  2  1  0  2  0  1  2  2  2  3  1  3  2  1  0  2
0133313322303110132021002210
0 0 3 2 1 2 1 0 1 2 1 2 1 3 1 1 3 3 1 2 2 3 1 2 3 2 0 2
0  0  0  1  3  3  3  3  3  3  0  2  1  2  3  2  1  0  1  1  2  0  2  0  0  1  3  2
1  0  3  3  3  1  2  3  3  2  0  0  0  2  0  2  0  1  2  2  0  3  2  2  2  0  3  0
2  3  3  1  2  2  3  3  0  0  2  2  3  0  3  2  0  0  1  1  2  1  0  1  1  1  1  0
1  0  1  0  1  0  1  1  1  1  0  1  0  0  0  0  1  0  0  1  1  0  1  0  1  0  1  0
