30133130202000
2 3 0 1 0 3 2 1 2 0 0 3 3 2
1 0 3 0 0 2 2 3 1 2 2 2 3 2
2  0  0  1  3  3  0  1  0  0  3  0  0  2
13123211021222
1 2 0 2 1 2 3 1 2 2 1 1 3 0
3  0  2  1  1  1  1  0  2  0  1  3  3  2
1 3 1 0 0 2 3 1 0 1 3 2 2 2
30231131101312
32133100011132
2 0 3 1 2 1 0 0 1 0 1 3 1 2
23230012022330
1 1 2 1 0 2 3 3 3 0 2 3 3 0
0  0  0  0  1  3  1  3  2  2  1  0  1  0
12230032321312
10312121030132
3  0  0  2  2  0  2  3  3  2  0  2  3  2
2 2 0 0 2 0 2 0 3 2 1 1 1 2
32201122000300
00001000100000
