100103030331130021132121020232203120
0  2  3  1  0  3  1  3  1  2  1  3  1  2  2  0  1  3  3  1  2  1  3  2  1  2  2  3  0  1  3  1  2  1  3  0
1 0 3 2 1 2 2 2 0 1 3 1 2 2 1 0 1 1 2 1 0 0 3 3 1 3 2 2 0 0 3 0 3 3 0 0
1  2  0  3  3  3  0  2  3  3  0  1  0  0  0  2  2  2  1  1  1  2  1  0  1  1  3  0  3  2  1  1  0  1  1  0
1 3 0 0 1 2 1 3 0 0 1 2 0 1 0 0 2 2 3 1 3 3 1 0 3 3 2 2 2 3 0 0 0 3 0 0
2  0  1  2  0  1  3  2  3  1  0  0  3  0  0  2  3  0  3  3  0  3  2  0  3  2  0  1  2  3  2  1  0  3  3  2
132023223123013320100323212221211230
1 1 3 0 1 3 3 0 1 1 2 2 0 3 2 0 3 3 1 0 2 1 2 1 2 0 2 1 1 3 0 1 0 3 0 0
3  3  2  2  2  3  1  0  1  2  0  3  1  2  1  1  1  0  2  3  1  3  3  3  0  1  1  0  2  0  0  3  0  3  2  2
111301031320331201021203212100103132
1  3  3  1  3  3  2  0  2  2  1  3  3  3  3  1  3  0  0  2  2  2  3  2  0  2  2  1  3  0  0  3  1  2  0  0
201300331033033310031123030321023122
200010000320011200001301100303102322
211021012121332130131123113033133302
2  2  1  1  0  0  2  1  2  1  0  1  3  3  1  1  1  2  0  2  1  1  2  0  1  3  2  1  0  0  2  3  2  2  1  2
0  1  0  0  3  1  0  3  1  2  2  0  3  0  3  1  3  0  0  2  3  0  2  3  0  3  0  3  0  2  1  3  1  3  3  0
3 2 0 0 3 2 2 1 1 1 1 2 2 1 2 3 0 1 1 3 2 1 3 1 3 3 1 3 1 2 0 3 1 1 1 2
0  0  3  2  0  3  3  0  1  2  0  3  0  1  1  2  3  2  1  2  0  1  0  1  1  3  1  0  2  2  2  3  0  0  3  0
110131322221221202031122001332222320
020112123102033102122321330200132012
1  3  3  3  0  3  1  0  1  0  3  1  3  0  0  2  3  3  2  3  2  1  0  3  3  0  2  1  3  3  3  3  2  2  2  2
2 1 0 1 3 2 0 3 2 1 2 3 1 3 3 1 0 3 0 2 1 1 0 2 1 2 2 3 2 2 3 2 0 1 0 0
313032111111001200213122023221300310
3  1  1  0  1  2  3  2  2  1  2  3  2  0  3  0  1  2  0  0  2  0  1  3  1  0  2  0  2  2  1  3  3  3  3  0
1 1 1 0 1 0 1 0 1 0 1 1 1 1 0 0 1 0 1 0 1 1 1 0 1 1 0 1 1 1 0 1 1 1 1 0
