2  0  2  1  3  1  2
0  3  0  0  2  0  2
1  3  2  0  2  0  2
3000300
3 0 0 1 2 0 0
1332322
2220332
1  2  0  2  0  1  0
0110100
3  2  2  2  0  3  0
3 1 2 3 2 0 0
0  0  3  0  1  1  2
1 0 1 0 0 0 0
