1 1 0 2 0 0 2 3 0 0 2 2 2 2 0 3 2 3 1 0 1 1 3 2
2  3  3  1  2  2  3  2  2  0  3  1  1  3  1  3  0  2  0  3  2  2  0  2
2  2  3  3  3  1  0  1  1  3  2  0  2  3  3  1  2  1  1  2  0  0  3  0
1 1 2 1 2 3 1 3 1 3 2 0 3 1 1 1 3 3 2 3 0 2 0 0
131231220030121332030130
100330323203313132213300
0 2 3 3 2 2 3 0 1 2 1 0 1 3 2 2 1 2 2 1 3 2 3 2
121311103221303121121012
1  2  3  2  0  1  2  0  1  1  3  1  3  3  2  0  1  3  0  1  0  2  0  0
0 0 1 2 1 2 1 2 2 3 1 1 0 3 0 2 1 3 1 3 3 3 2 2
3  1  0  2  0  3  1  0  1  2  0  1  2  1  3  0  1  0  0  3  0  3  3  0
200201202123023220230130
3  0  0  1  3  3  3  2  2  1  2  2  2  3  0  1  3  3  0  3  2  3  3  2
3  1  1  0  1  2  2  2  3  3  0  3  3  2  1  0  1  0  3  0  0  2  0  0
1  3  2  1  1  2  2  1  1  3  3  1  2  0  1  2  3  3  2  2  0  3  0  2
2  2  1  3  0  3  0  1  1  1  0  3  3  3  1  0  1  0  1  1  1  1  3  0
3  2  1  1  2  0  3  3  0  0  0  3  3  1  3  3  2  3  3  2  2  1  1  2
102103112211223013213312
1  2  2  1  1  0  3  3  2  0  2  2  0  0  2  2  3  0  2  0  1  2  1  2
3 1 2 3 1 1 0 0 3 1 2 0 1 3 3 2 3 2 1 3 3 0 1 2
323202100102113021030030
3 3 3 3 1 1 1 2 0 1 2 1 0 2 3 2 3 1 0 3 0 2 0 2
1 0 0 3 1 1 1 2 0 2 1 3 1 0 2 3 0 2 1 1 2 2 0 2
110102022022211103023132
2  3  2  2  3  1  0  0  2  0  1  1  3  1  0  3  1  1  2  1  2  3  1  0
321000021313203301320300
313000232333122311212220
3  2  0  3  3  3  3  2  2  3  1  2  2  1  3  3  3  3  2  1  2  0  0  0
111010101001110011011110
