0  1  0  3  3  2  0  1  3  1  3  0  2  0  1  0  0  3  1  0  3  1  2  1  0  0
1  1  0  3  1  3  1  3  2  3  0  0  3  2  2  3  2  1  1  0  0  1  3  0  0  2
0  0  2  2  2  2  2  2  0  2  3  0  1  2  3  2  0  0  1  3  0  1  1  2  2  0
10300132000122030203322032
1  0  1  0  3  3  1  2  0  0  1  2  3  1  3  0  0  1  3  0  2  0  1  3  2  2
3 2 3 0 2 1 3 0 1 2 2 1 3 0 3 2 1 0 3 2 3 1 0 1 1 2
1  3  0  2  1  2  0  0  2  2  2  3  3  0  2  0  0  1  1  0  2  1  3  1  3  0
31222020003022231110021222
03303111001013320131030232
3 1 2 0 2 3 1 2 2 0 3 3 0 2 1 1 2 0 1 0 1 1 0 1 0 2
2 2 0 0 1 1 0 1 0 0 1 1 3 1 2 0 1 1 2 0 0 1 0 3 1 2
1 1 3 3 3 3 3 0 0 2 3 1 0 1 1 3 2 0 3 2 1 0 3 3 2 2
20013123231123211233010222
1  0  0  3  0  1  2  1  3  1  2  3  2  1  1  3  3  0  1  3  2  2  1  3  0  0
3  2  2  1  3  0  1  1  0  2  2  2  1  3  0  3  2  0  3  2  0  1  3  3  1  0
22313313203223201231100310
3 2 2 3 3 1 2 1 1 0 2 3 1 3 3 2 1 0 3 0 3 3 1 2 0 0
3  1  2  2  2  0  3  2  1  0  0  1  3  1  3  0  3  1  2  0  1  2  1  2  2  0
3  0  1  3  0  3  1  3  1  3  1  0  1  2  0  1  1  1  0  2  1  0  1  0  3  0
1 1 1 1 3 2 3 3 2 2 3 1 2 1 3 3 1 1 1 0 1 1 3 2 0 0
21111022320202331231312102
31231220312101312130313322
13203213320231333212000330
20233222233030123233113110
22223110321131033313122120
1 2 1 3 0 0 0 2 3 1 0 0 1 1 2 1 1 0 1 2 3 3 0 2 2 0
1  0  1  1  0  1  0  0  0  1  0  0  0  0  0  0  0  1  0  1  0  1  1  0  1  0
