0 0 0 1 0 3 3 2 2 0 3 3 2 2 3 1 0 0 0 1 0 0 2 1 3 3 1 3 3 3 2 2 2 2
3113100132103020112231211211001230
1  2  0  1  2  3  1  3  2  2  3  2  0  0  3  1  1  2  2  1  2  2  2  3  2  2  3  2  1  2  3  2  3  0
2 3 1 3 2 3 2 0 2 1 0 0 2 1 3 0 0 3 2 0 0 3 2 0 0 3 2 1 3 2 3 2 3 0
1000201200330202133323130301311222
1  0  3  2  3  2  0  2  0  3  0  1  1  1  3  2  2  0  0  0  3  1  3  3  1  2  1  3  3  2  1  2  0  0
0 2 2 0 1 3 3 1 2 1 3 2 0 3 0 1 1 0 0 0 1 1 1 2 0 2 3 0 0 0 1 3 3 2
1  3  3  3  2  0  3  2  3  3  3  1  0  2  3  1  2  2  3  0  2  2  0  3  2  1  3  0  2  1  1  3  3  2
1233331312322301121130332312111320
2232213132323123211213320200113032
0 0 2 0 1 1 2 1 0 1 0 1 0 3 2 0 2 3 1 3 2 3 0 3 3 0 0 0 3 1 0 1 2 0
0 1 0 3 3 0 0 0 0 2 1 3 2 3 3 0 1 0 3 3 3 3 1 2 1 2 0 1 3 3 0 3 1 0
1 1 2 1 2 1 2 2 3 3 0 3 2 3 0 0 2 2 1 3 2 0 0 2 2 0 2 2 1 2 1 1 0 2
3  2  0  1  1  0  2  1  1  2  2  2  0  3  1  0  0  2  1  0  1  1  2  1  2  2  1  2  0  1  1  3  1  0
2 1 3 2 2 1 1 0 2 2 0 0 0 1 2 2 2 2 0 2 2 1 2 1 0 0 0 0 0 3 3 2 3 2
3222021221220023310130332223121322
3  1  3  1  1  2  3  0  0  0  3  1  1  2  0  0  2  2  0  0  0  1  3  1  2  3  0  1  2  2  3  1  3  2
0000222321110031223202210012112210
3  0  0  2  3  3  3  0  0  3  2  0  3  3  1  1  0  2  1  0  2  3  2  1  3  1  0  3  3  2  1  2  0  2
0013120203102112001130100320212122
1110021333222011113020003131323312
2  2  3  3  0  2  0  0  1  2  3  0  0  2  2  0  3  1  0  1  0  1  2  3  1  1  2  2  3  1  1  2  3  0
0 1 2 1 2 0 2 2 0 1 3 1 2 0 3 2 3 1 3 1 2 0 3 0 2 0 2 1 2 1 1 1 3 2
0221220312010313303200233302300122
2222010111100010303033030332033122
0 0 2 0 1 2 2 2 3 1 0 2 3 1 2 1 2 2 0 3 3 3 2 0 1 0 3 1 1 2 0 1 2 2
2033301130230033000333023130122030
3  0  2  1  3  2  0  0  2  0  0  0  1  3  1  1  1  1  2  0  0  2  2  2  1  2  0  1  1  3  1  3  1  0
1  0  2  3  3  3  0  1  3  2  0  2  1  3  3  3  2  1  1  0  2  3  1  2  2  0  2  3  3  1  3  2  2  2
0011110101101001001000001110110010
