2  2  1  2  3  0  2  3  2  1  0  3  3  0  3  1  2  3  2  3  3  0  1  3  2  2  3  1  3  1  0  2  0  0  2
1  3  0  3  3  1  2  3  1  0  1  3  1  2  1  2  3  2  2  0  0  2  3  2  1  0  3  1  1  2  0  2  3  0  2
2 1 0 3 1 1 0 1 0 1 3 0 0 3 1 3 0 2 3 3 2 2 2 0 0 3 3 3 3 3 0 3 3 3 0
0  3  2  0  1  2  3  1  1  1  2  0  3  0  3  1  0  2  2  1  2  0  2  0  1  3  0  3  3  3  0  1  2  3  0
0 3 0 1 2 0 1 3 2 2 1 3 1 1 3 2 1 0 0 3 3 0 3 3 0 2 0 2 2 1 3 0 3 3 2
1  3  0  1  0  2  2  1  2  3  1  2  1  2  1  3  1  2  2  2  1  3  3  3  0  1  0  0  0  3  3  3  2  2  2
10223121033311112022133133221003220
1  0  3  1  2  0  1  3  1  0  1  0  3  1  1  2  1  3  0  1  2  3  0  0  2  1  0  1  1  3  0  0  0  1  0
1 0 3 3 0 0 1 2 3 0 0 0 2 3 0 3 2 3 0 0 2 3 1 1 3 3 3 1 3 0 0 3 2 3 0
13033330130212212123210111120023110
1  0  1  1  3  2  3  0  2  0  0  0  0  1  0  3  0  1  2  1  0  3  1  0  2  2  0  3  0  1  1  1  3  1  2
3  1  1  0  3  1  2  0  2  1  3  3  2  0  1  2  0  2  2  1  0  0  0  1  2  3  3  0  3  0  1  2  1  0  0
10110221321222133120111022211013230
11321001102123010121201110011311022
01011011111010111001100101110000010
