1 2 3 0 1 3 2 3 2 2 0 3 3 3 1 1 2 1 3 3 1 2 2 0 3 0 3 2 2
32312312020233011322313001002
0  3  1  1  2  3  1  2  1  0  3  0  2  1  0  3  0  3  1  0  2  2  0  0  3  3  2  0  0
23112301320301131303321011232
0  2  0  2  0  3  0  3  2  3  0  3  3  3  3  0  1  1  3  3  3  1  3  1  2  2  0  2  0
2  3  2  2  0  0  2  1  2  2  0  1  3  2  1  2  0  1  2  0  3  0  3  3  0  2  1  3  0
2  1  3  0  1  1  3  3  3  3  0  3  0  2  0  2  1  1  3  2  1  0  2  1  3  1  2  0  0
02211230100003320133033023312
02123000112103322320123333200
3 1 0 2 1 1 3 3 0 1 1 1 0 1 1 2 2 3 3 0 0 2 1 3 0 3 1 3 2
2  2  0  2  0  0  1  0  3  1  2  2  1  2  3  0  1  3  0  1  0  0  2  3  0  0  1  3  2
3 1 2 0 1 2 2 0 3 2 2 1 0 0 2 2 2 2 3 0 0 1 0 2 0 0 2 1 0
0  3  3  2  3  2  2  2  0  3  0  1  1  3  3  1  1  0  1  0  3  1  3  1  1  0  2  1  2
2 1 3 1 0 0 2 3 0 3 0 1 1 1 2 1 3 0 0 0 0 0 0 0 1 1 2 3 2
1  1  1  2  1  2  2  0  3  3  1  0  2  1  3  3  0  1  0  1  0  3  3  3  0  2  3  1  2
30123023122201102312323133130
3  3  1  0  3  1  1  1  0  2  0  2  0  0  1  0  1  3  2  2  0  0  3  2  3  2  3  1  2
3 0 2 0 1 1 1 3 2 1 1 2 2 0 2 1 2 0 3 3 2 0 0 3 3 0 2 3 0
0  3  3  1  3  1  1  3  2  2  2  0  2  2  1  0  3  3  1  2  0  1  2  0  1  2  2  3  0
3 3 1 0 1 0 2 1 3 0 0 2 0 3 3 0 1 1 2 2 2 1 2 1 0 1 0 2 0
10120310022210030131033112222
12111311312010022300113030302
1 1 2 3 0 1 2 0 0 0 1 3 1 2 2 2 3 1 2 3 3 1 1 1 0 3 1 2 2
2  2  2  2  1  0  0  1  2  0  3  1  2  1  1  3  3  3  1  0  0  1  3  0  1  2  2  3  0
13133221213032010212002212130
1 0 1 0 1 0 0 1 0 0 1 1 0 0 0 1 0 1 1 1 0 0 0 1 0 0 1 1 0
