0312013013211122323010312312133031323012
2031112101103102013313013021230003202020
1 2 2 0 1 1 2 0 3 2 1 3 3 2 3 1 3 0 1 1 2 1 0 3 3 3 2 3 0 3 0 1 1 0 2 2 3 2 3 0
3 3 1 2 2 2 1 1 1 3 1 1 3 3 0 2 1 0 1 1 2 0 2 2 2 1 1 1 0 2 0 3 0 0 3 1 0 1 1 0
0  3  3  0  2  1  2  3  3  2  2  2  3  0  0  0  3  2  1  1  1  3  1  2  3  2  2  2  0  0  3  3  0  1  2  0  3  2  3  0
2  0  1  1  2  3  2  1  2  3  2  0  2  3  0  1  1  0  2  1  2  3  3  0  2  2  2  3  2  1  0  0  1  0  2  3  0  0  0  0
2300331220133003021011102003112100210302
0 1 3 3 3 1 1 0 0 3 0 1 0 3 3 3 3 0 3 2 2 2 2 3 0 1 1 0 1 2 2 2 2 2 0 0 1 2 3 0
2 0 3 0 2 0 0 3 0 0 3 3 1 1 0 3 1 2 3 2 0 3 2 2 2 3 0 0 2 2 0 2 1 2 1 0 3 0 3 2
0010101220020212310322331120313011310302
3 1 3 2 1 1 3 3 0 0 1 1 3 3 2 3 2 2 2 1 0 0 1 2 1 1 0 0 3 1 1 1 3 1 1 1 0 3 0 0
0 0 1 2 3 3 3 2 2 3 3 2 2 1 3 0 2 0 3 0 1 3 1 3 0 3 2 2 0 0 2 3 3 2 2 3 3 2 3 2
0  2  2  0  1  1  3  3  0  0  1  1  3  0  1  3  2  3  1  3  3  2  1  3  3  2  0  1  1  1  3  3  1  1  0  0  1  1  1  0
1133123101133322221012101301132302311102
0 1 1 1 0 1 0 1 0 1 0 0 1 0 1 0 1 1 0 1 1 0 1 1 1 0 0 1 1 0 0 1 1 1 0 1 1 1 0 0
