3110232332332020
0132033110321222
0  3  3  1  3  0  3  2  0  0  2  1  1  3  2  2
2  0  2  1  3  0  0  0  3  0  2  0  2  0  3  0
2111113231311122
3 0 0 3 0 1 1 1 0 0 1 1 3 0 1 2
1021232103123310
0  2  3  3  1  1  1  0  0  2  0  2  2  1  0  2
1 3 0 2 0 2 3 2 2 3 3 1 3 0 1 2
2  1  0  2  3  1  0  1  2  0  1  1  3  3  2  0
0013101013022300
3  0  0  0  1  3  3  1  2  0  3  1  1  2  0  0
0  0  1  3  1  1  1  1  3  1  3  1  2  2  3  0
0302121121022320
1 0 1 0 1 1 2 3 3 2 2 3 2 0 2 0
2  3  2  2  0  0  1  1  3  1  1  3  0  1  0  0
1233211320113102
0322203001132010
2  3  1  0  0  0  2  0  2  1  3  1  0  0  3  2
0 0 0 2 3 2 1 0 0 1 2 3 2 3 2 2
2  1  1  1  3  0  2  3  2  1  2  1  3  2  2  0
2112131011303132
1  0  2  0  3  1  3  3  1  3  1  1  0  0  2  2
1321223030100032
0000101010111110
