2131111010110100121102200
2  2  2  1  2  2  3  0  0  0  3  2  3  3  1  3  0  1  1  2  3  0  3  2  0
3  0  1  3  1  0  3  0  3  0  1  2  1  0  1  2  3  0  0  1  2  1  1  3  0
0322323001222133132003210
0  0  1  2  0  3  0  3  3  1  3  3  0  1  3  2  1  1  1  1  3  2  2  1  2
3 1 0 3 2 1 1 0 1 1 0 2 3 3 3 3 0 3 3 1 0 3 1 2 0
3  1  2  1  2  1  2  2  0  3  2  2  1  1  1  1  0  3  1  3  1  1  0  3  0
0002130330102213023320002
2  3  0  1  1  2  0  1  2  2  3  1  3  2  0  3  0  0  1  0  1  1  1  1  0
0  0  1  3  3  2  1  2  0  3  3  3  3  0  1  0  0  0  1  3  3  2  1  0  2
3 0 1 2 3 3 2 0 1 3 1 3 3 1 1 0 1 0 2 1 3 1 2 2 0
1 0 2 1 0 1 0 3 1 1 0 2 0 2 2 1 2 0 0 1 0 2 0 2 0
0  3  3  2  2  2  0  1  2  0  1  1  1  3  0  0  0  3  3  1  1  3  0  1  0
1 0 1 0 0 3 0 3 2 0 1 1 0 3 1 0 3 3 1 2 2 3 0 3 0
2333331100233102033301310
1  2  1  2  2  1  0  2  2  0  1  1  0  1  1  0  0  0  3  0  1  3  1  1  0
3031123032120202021200132
3 1 3 1 1 3 2 3 0 1 2 3 2 2 0 1 3 3 2 2 1 1 1 3 2
3102211333110033223012210
0223022132022211221302120
3220333323313321010212322
1010110111111110001001100
