0 0 1 1 1 1 0 0 0 1 2
03300121012
3 0 0 2 1 1 2 1 1 2 2
0 2 0 3 0 2 0 2 2 3 2
30012212312
2  2  0  3  2  2  2  2  1  0  0
21330303330
2  3  2  1  3  3  2  3  3  0  2
01100101110
