01011210023130
3  1  0  3  3  2  0  3  2  3  2  1  1  2
21002012033322
22021211301130
1  3  3  2  0  1  1  3  1  2  0  1  2  0
3 0 2 1 0 0 2 0 1 2 3 0 1 2
00323032132132
3 0 1 0 2 0 2 2 0 2 0 3 3 2
0 3 0 1 0 3 2 1 0 0 1 3 2 0
32213120310102
32200033020112
3  2  1  1  3  1  2  3  2  1  0  0  0  0
00322111110332
0  0  1  3  3  3  2  1  1  3  1  0  1  0
1  2  1  1  2  2  3  1  2  0  2  2  1  0
11100322032210
1 3 2 2 0 0 0 1 2 2 0 1 2 0
31110120322232
2 1 1 3 0 0 0 1 1 1 2 0 1 0
0  0  0  2  1  0  2  2  3  2  0  1  3  0
3 1 3 3 1 1 0 3 2 1 1 1 3 2
33113201120020
2  2  1  2  0  1  3  3  3  0  0  3  0  0
03320011323202
0 2 3 3 2 3 3 2 2 2 1 2 3 0
0 0 0 2 0 0 2 0 3 1 1 2 1 2
0  0  0  1  0  0  0  0  0  0  1  0  0  0
