212201333201030030020
3  2  0  2  0  3  1  2  0  1  1  3  3  0  1  1  0  2  0  0  0
3  1  1  3  1  3  0  2  1  0  0  1  3  1  0  3  1  3  3  3  0
1  3  2  0  3  3  2  0  0  0  1  2  1  1  0  3  1  3  1  2  2
3  1  3  0  0  1  3  0  3  1  1  2  0  0  2  0  3  3  1  2  0
130033211002313210102
001030102013200103302
0  3  1  0  3  3  0  0  2  2  1  2  2  1  3  3  1  1  3  2  0
131331210031133333030
0  3  1  3  2  3  3  1  0  0  0  3  0  0  1  2  1  1  2  1  0
2  0  3  3  2  1  3  0  0  2  3  2  0  0  0  1  0  1  1  2  2
1 3 3 3 3 3 3 0 0 3 1 1 2 1 2 1 1 3 1 2 0
2 2 1 3 3 0 3 1 2 3 0 1 3 1 0 3 1 2 1 2 2
3 0 1 3 0 0 3 2 0 1 0 2 1 2 2 2 3 1 2 0 2
303212210032203020230
0  3  1  3  0  0  3  0  2  1  0  1  0  3  0  3  1  1  1  2  0
1  1  3  0  3  3  3  2  0  2  2  2  1  2  1  2  0  0  2  3  2
1  2  2  2  1  1  1  0  0  3  2  2  2  2  2  1  0  0  1  0  2
0 2 0 3 0 1 0 0 0 2 0 2 1 3 0 2 0 1 0 3 2
3 0 3 0 2 1 0 0 0 0 2 3 1 3 3 1 0 0 2 2 0
0 3 0 2 3 0 1 1 1 0 1 1 0 2 1 3 0 2 3 1 2
022311332203332012212
0 2 1 2 1 0 1 1 2 2 2 2 0 1 2 0 0 0 0 0 2
1  0  2  3  2  1  1  1  1  3  2  2  1  2  2  2  2  2  0  0  2
1  3  3  3  1  0  1  1  0  1  3  2  0  3  1  0  0  3  3  1  2
033113101112010032010
2 3 0 1 1 0 3 2 3 1 1 3 2 0 3 2 2 2 0 2 0
2  1  2  3  1  2  0  2  3  0  3  1  1  0  2  0  1  0  0  1  0
1  0  3  0  3  0  3  3  3  2  1  1  2  0  2  1  3  3  3  1  2
0  0  1  1  0  1  1  0  0  1  1  1  0  0  1  0  0  0  1  0  0
