1  1  3  2  1  3  1  1  3  2  3  1  2  0  2  3  2  1  1  1  0  1  0  1  2  2  2  0  0
3 0 1 1 3 3 1 2 0 1 1 3 3 0 1 0 0 0 0 0 0 0 2 1 0 1 2 3 0
01001113221123033320330320130
3  0  2  3  1  2  1  1  0  2  2  3  0  0  2  0  3  2  1  2  1  1  0  3  1  0  3  3  2
0  0  1  3  0  2  3  1  3  3  0  0  3  0  2  1  1  3  2  1  2  3  2  1  2  3  3  3  2
1  3  0  3  2  2  0  0  3  2  2  0  1  3  0  1  2  2  3  3  0  3  3  2  1  1  3  1  2
2 0 1 3 0 1 0 1 2 1 2 0 3 1 3 3 1 3 2 2 3 1 2 1 3 2 2 2 2
32031331320330302223230330322
03000332211031332232200111212
1  1  1  2  0  2  0  3  0  1  2  2  0  1  0  2  0  0  1  0  3  1  3  3  1  1  3  2  0
02133202303322100303011123332
3 3 1 3 0 0 1 2 2 3 2 1 0 1 2 3 0 1 3 3 2 3 1 2 3 1 1 3 2
22222022120303120332203021310
31312232232022220111223103032
3 1 1 1 1 0 0 0 0 3 0 3 1 1 0 2 2 1 3 0 2 3 1 1 0 1 0 1 0
32203010322011111103233223312
1 3 2 3 2 3 0 0 3 3 3 1 2 3 0 0 1 2 2 2 2 3 2 0 3 3 1 1 2
0  3  1  0  0  3  1  0  1  0  0  2  0  1  0  2  0  1  3  0  3  1  2  2  0  1  2  0  2
03020222320101321123030221312
3 3 3 1 0 0 1 1 1 2 2 3 3 0 3 0 2 3 2 1 2 1 3 2 0 2 3 2 2
00303122101223012010302021320
3  1  2  3  1  0  1  0  3  1  2  1  1  1  1  1  1  1  2  2  0  2  2  3  0  0  1  1  0
1 0 2 0 2 0 1 1 2 1 0 2 0 0 0 2 1 3 3 3 2 0 3 0 2 0 2 1 2
3 0 3 0 2 0 3 3 3 1 2 0 1 1 0 0 2 0 1 2 2 0 2 1 1 1 0 3 0
13321202033003003101031021322
2 1 2 0 1 2 0 0 0 2 1 0 3 1 1 1 2 3 3 1 2 1 1 3 1 3 1 2 2
21310130021030301023301310020
32133121202203120320132233202
32321010213222032013103132320
13313120301113122231032322232
0  0  0  1  1  0  0  0  1  0  1  0  1  0  1  1  1  0  0  1  0  1  0  0  1  1  0  0  0
