3 2 3 3 2 1 2 3 3 3 3 2 2
0 3 3 3 1 1 0 3 3 0 2 2 0
2312230210112
3 3 3 2 2 3 0 0 2 2 3 1 0
0010120332122
0011220333132
0 2 3 0 0 0 1 0 1 0 0 3 0
3  0  2  0  0  1  1  2  0  0  1  2  0
3  3  0  3  1  0  3  0  1  0  1  1  2
3  1  3  1  3  0  3  2  2  3  2  1  0
1 3 0 2 2 2 2 3 1 1 0 1 0
3  2  0  3  3  0  0  1  3  3  0  0  0
3301301033300
0  0  0  0  2  0  1  0  2  1  2  3  0
0110110011000
