2 3 3 0 1 0 1 3 0 1 0 3 2 3 1 0 1 2 0 3 2 2 3 2 3 1 2 2
3130232113320002130012233312
1111313133231030030120100302
3 1 2 3 2 3 0 3 2 2 0 1 3 2 1 0 2 2 2 3 1 0 1 0 1 2 3 0
2333111111103230012231331210
2  3  0  1  2  0  3  2  2  2  1  0  0  1  1  3  1  2  2  1  0  2  2  3  3  0  2  0
0  2  0  0  0  0  0  1  0  1  2  2  2  3  1  0  3  3  3  3  0  1  2  0  2  1  0  2
3  2  1  0  0  2  2  1  3  3  3  1  0  0  1  1  1  3  3  0  1  1  0  3  0  2  3  2
0  3  3  0  2  3  3  0  0  1  1  2  0  3  0  1  1  1  3  0  1  0  2  1  1  1  3  0
2  2  1  1  1  3  2  1  0  2  2  3  0  2  3  1  2  2  1  1  1  3  2  3  3  1  3  0
2  1  3  2  1  2  3  3  3  1  1  3  1  1  1  3  3  2  2  1  3  2  3  0  3  3  1  0
2 1 0 3 3 3 1 3 2 3 0 2 2 0 0 3 2 3 2 3 2 3 1 3 1 1 0 0
3131302001323310230311202112
2030022112320313123210332100
0  3  1  2  2  1  1  1  2  0  1  1  3  1  0  2  2  2  0  3  1  1  2  2  0  0  3  0
0  2  3  0  0  2  2  2  2  1  0  3  1  2  1  0  1  3  3  2  2  2  0  1  0  0  0  0
2 2 0 0 0 2 2 3 3 2 0 2 3 3 1 3 0 1 1 3 2 0 3 2 2 0 1 0
3  3  1  2  0  0  2  1  1  1  3  0  2  2  2  3  3  3  2  3  0  2  2  2  3  1  2  0
3 2 3 0 1 0 3 3 1 2 0 0 1 2 1 3 3 1 3 0 3 0 2 3 0 1 3 2
2  1  2  3  1  3  0  2  1  2  2  1  2  2  2  2  1  1  2  2  1  3  2  0  2  0  1  2
0000132023020120113110212020
3  3  2  3  1  0  1  3  0  3  2  2  3  2  0  1  1  2  3  2  2  1  3  1  0  2  1  2
2 3 1 2 3 1 0 1 1 1 1 1 2 0 3 2 2 2 2 3 0 3 1 3 1 0 2 0
2  1  2  2  3  2  0  0  2  2  2  3  3  1  2  1  2  0  1  0  3  1  0  0  1  3  1  0
0010111100100011111011100110
