13033312222331311323212
2  0  2  3  1  1  1  3  0  0  3  0  2  1  1  1  2  1  1  3  2  1  0
3  1  2  1  0  1  2  2  1  0  2  2  0  3  3  1  1  2  2  2  2  2  2
20112101303232031111112
2  2  0  2  3  0  2  0  0  3  0  2  3  2  3  3  2  3  1  1  3  3  2
3 3 2 2 3 0 1 3 0 0 1 0 0 0 0 1 1 0 2 3 1 1 2
30230323120020021021220
00221101233333233222032
3  1  0  0  2  1  0  0  1  0  3  0  0  0  3  1  3  3  1  0  0  3  0
3  0  3  1  3  2  1  3  1  0  0  3  0  3  1  1  1  2  0  0  3  3  2
1  2  0  2  2  1  0  3  3  2  3  2  3  1  3  3  3  0  0  1  3  2  2
1  1  1  0  3  0  0  1  0  2  2  0  3  0  1  3  1  0  2  3  3  2  2
12312122022231221021030
30030210230100000332220
0  3  1  0  1  1  0  2  0  3  3  3  0  3  0  1  2  3  3  1  2  0  0
3 3 1 3 3 2 3 3 3 3 3 2 3 1 0 0 2 0 0 3 3 2 0
0 0 3 0 1 2 0 1 3 3 1 3 2 2 3 1 0 3 0 2 0 0 0
13300311223131321102310
32301123022332211201220
23203330303013120233022
33322203122112132202332
2 2 3 2 1 2 2 3 0 3 2 3 0 0 3 2 0 1 2 2 0 3 0
1  0  1  1  0  0  1  0  0  1  0  0  0  0  0  1  1  1  0  1  1  0  0
