1  2  3  0  2  2  0  1  0  2  1  2  3  0  2  0  0  1  0  2  1  3  3  0
112002230320313030121312
1  2  1  1  2  2  1  2  3  0  2  2  1  3  2  1  2  2  3  2  3  3  2  2
0  1  1  2  3  1  0  1  1  2  0  0  0  1  3  0  1  0  1  2  1  2  3  2
0 0 3 0 2 1 0 3 3 1 3 0 0 2 0 1 0 0 3 1 1 1 2 2
223332111101133313131000
1  3  2  0  2  2  3  2  3  2  2  3  0  3  2  2  0  3  3  1  2  0  1  2
003100130031320130012030
302121133001311013220230
1 2 3 3 1 1 2 1 1 3 1 0 0 2 1 2 3 2 3 3 3 2 0 0
030313003202032133121112
3 0 2 2 2 0 1 3 2 3 0 3 3 2 1 0 0 3 1 1 0 1 2 0
0  2  1  1  3  0  0  0  2  2  3  2  2  2  0  0  1  1  1  0  0  3  1  2
3  2  2  3  2  3  0  0  2  0  2  2  0  2  0  3  1  2  2  3  0  3  1  0
031322331330221200120330
010000101110101010011100
