3 3 2 3 2 3 2 1 0 2 0 1 0 3 2 1 1 2 3 3 2 3 2 1 1 2 1 0 1 1 1 3 2 3 3 2 2
3 3 3 1 2 3 0 2 1 1 3 3 0 3 2 3 0 0 0 1 2 3 3 2 1 1 3 3 1 2 2 1 3 3 0 2 0
2  0  2  0  3  3  1  2  2  3  3  1  3  3  3  3  3  3  2  2  0  2  2  1  3  1  0  0  1  2  3  0  3  1  2  1  0
2 3 3 3 2 0 2 1 1 1 3 3 0 3 3 0 0 1 3 1 3 0 0 3 0 3 2 0 3 3 2 2 3 1 1 2 2
2 3 1 0 0 2 2 2 2 1 0 0 3 1 3 3 2 1 3 1 1 3 2 0 1 0 1 1 1 1 3 1 1 0 3 1 2
3  1  2  2  1  0  1  3  0  1  1  3  1  0  3  3  1  3  3  3  3  1  0  2  2  2  1  1  1  2  1  3  3  1  0  3  0
2  3  2  3  3  3  0  1  2  1  3  2  3  3  3  0  0  3  0  1  3  1  1  1  3  1  2  1  0  1  1  3  1  1  1  1  2
3  3  2  2  2  3  3  1  0  1  0  0  3  3  2  3  1  2  0  3  2  3  1  3  3  1  2  3  0  3  0  0  2  1  3  0  2
0112001230032112023011301332030331022
2222302311031312010011122113033111320
1201331012000233311021330223201023210
3020310300020300301332223031320233022
0 0 1 1 1 0 1 2 1 0 3 1 2 0 2 3 3 2 2 2 0 0 3 1 2 2 1 0 0 2 3 2 1 3 3 1 2
1  1  2  1  3  1  3  1  3  3  3  1  3  2  0  3  0  0  0  2  0  0  0  0  1  3  0  2  0  2  2  2  2  3  1  0  2
2  0  0  3  0  0  0  1  3  0  2  3  1  0  1  1  2  1  1  2  3  2  0  1  0  1  0  0  1  3  3  1  1  0  0  2  2
1132231131201233300020012100102203020
1031213121011002320111133012023332122
3 3 1 2 3 1 0 1 3 1 0 3 1 2 3 0 1 2 0 2 1 1 1 0 0 1 0 3 1 3 2 3 1 1 2 1 2
0  3  2  1  0  3  3  0  1  0  0  1  1  1  1  2  3  3  3  1  2  3  3  1  2  3  2  0  0  0  2  2  3  0  3  0  2
0 0 3 2 3 1 0 3 0 3 2 0 2 3 3 1 3 1 3 0 2 2 1 1 2 3 2 1 1 1 3 0 3 1 2 3 0
2  3  1  1  1  2  0  0  2  2  3  1  1  2  3  0  0  1  2  3  3  3  3  3  2  2  2  1  2  1  1  1  2  2  0  2  0
0  3  2  3  3  2  0  3  2  2  2  1  0  2  0  0  0  2  2  1  0  2  0  2  3  2  0  1  1  3  2  0  3  3  0  1  0
2001001101313001021130303130111303122
1 3 1 3 3 2 2 3 3 1 1 3 1 2 1 1 0 3 1 1 2 1 2 2 2 2 3 3 0 3 1 0 1 2 2 2 2
1 3 1 3 1 1 2 3 1 2 3 3 0 3 0 0 2 2 0 3 2 3 3 1 1 0 0 3 3 1 2 0 3 2 3 3 0
1 1 0 1 1 0 0 1 1 1 1 0 1 0 1 1 1 1 0 0 1 1 1 1 1 1 1 1 0 0 1 1 1 1 0 0 0
