2 3 1 1 3 3 3 1 2 0 1 1 3 1 1 3 0 1 2 1 0 1 2 3 1 1 0 0 3 2 2
1210330330331301000313120111200
0  3  1  1  2  3  2  3  3  0  3  2  3  1  2  3  0  2  3  1  2  1  0  3  2  1  0  2  1  3  0
0 1 1 3 2 2 0 0 2 3 2 2 3 0 2 1 1 2 0 1 0 0 0 3 3 2 2 1 0 1 0
2333312023322011033121322331110
3311102022320112010222211302312
1  0  2  0  0  2  3  1  0  3  2  0  1  2  2  3  0  3  0  0  0  3  1  2  2  3  1  3  2  2  2
1212003223211222031132033033312
0110120031313012011212010200212
0  3  1  1  0  3  1  0  1  0  3  2  2  0  0  1  3  1  3  3  0  1  2  2  2  0  1  0  3  0  2
3 2 0 3 2 1 0 1 0 1 2 0 0 0 2 0 1 3 3 2 3 2 2 3 0 3 3 2 0 2 2
2102212332201122001013022302120
3  2  0  3  1  0  0  3  1  0  3  0  3  1  1  2  0  0  0  2  1  2  3  0  3  1  1  3  3  2  2
1 1 3 0 1 2 2 1 3 3 3 2 3 0 1 2 0 3 0 3 0 3 0 2 1 1 0 2 1 1 0
1  0  0  2  2  3  1  2  3  0  0  0  2  1  0  3  0  1  2  3  1  3  1  2  2  1  1  2  2  0  0
1  3  3  1  0  3  1  1  2  3  0  2  0  1  2  2  3  3  3  2  0  3  1  2  2  0  2  1  0  1  2
2  0  0  1  2  0  3  1  1  3  3  0  3  0  0  0  1  3  0  1  3  3  3  2  0  2  1  0  0  3  0
0320200113200113201013130203330
3 3 3 2 2 1 0 3 3 0 1 3 0 0 3 0 2 2 3 3 2 3 1 2 1 3 2 0 0 3 0
1222220300102011130313302210030
0 2 2 2 0 0 2 0 0 2 3 1 3 0 0 3 0 1 3 3 0 0 3 0 2 0 2 1 2 2 0
0 1 0 0 0 0 0 1 1 1 0 1 0 1 0 1 1 0 1 0 0 0 0 0 1 0 0 0 1 1 0
