3 3 3 1 0 2 1 1 0 3 1 3 0 1 2 3 2 3 3 0 1 2 0 1 1 3 2 2 2 0 1 3 3 3 2 0
131321301023213000021323323221303322
010231311322001331000303113323002032
2 1 0 2 2 1 2 0 3 3 2 0 3 3 1 2 2 0 1 2 1 0 0 2 3 1 0 3 3 3 1 2 1 3 3 2
0  3  2  3  2  3  0  1  3  0  1  3  2  1  3  0  1  2  0  1  2  3  3  2  3  2  0  1  1  1  1  2  1  1  3  2
3 2 0 2 2 3 2 2 0 0 3 3 3 1 2 3 2 0 0 2 1 2 1 3 2 0 1 1 2 2 3 3 0 2 1 2
100022121311301220001020023111323020
201120011303311003202223332103022030
0 3 1 2 1 3 1 1 1 2 1 0 2 1 3 3 3 0 0 3 1 3 3 1 2 2 3 2 1 2 1 0 1 0 0 2
2  1  2  2  0  1  2  0  3  3  3  3  0  3  2  2  1  2  1  3  3  3  0  1  1  2  0  1  3  1  2  0  0  2  3  2
3 0 3 0 0 3 2 1 1 2 3 0 1 3 0 0 3 1 1 3 1 0 3 3 0 1 2 0 0 2 3 3 3 0 3 2
0 2 0 0 1 1 2 0 0 3 2 0 0 2 1 2 1 1 2 1 2 2 3 3 2 0 1 1 3 0 1 1 0 1 0 2
3  1  1  1  3  3  0  3  1  3  3  2  0  2  3  0  0  1  2  2  2  3  3  1  2  1  3  1  3  0  0  2  2  2  2  2
132113212203313010103110233031332112
3 0 2 1 3 3 1 1 3 1 2 2 0 0 2 2 3 2 2 2 0 1 3 1 3 1 1 3 3 2 3 1 1 3 2 0
0 1 1 2 3 3 0 3 3 1 2 0 3 1 2 2 0 0 3 3 0 2 3 2 3 3 2 2 1 2 1 2 2 2 2 2
233021233103120213002222322232113320
3 2 3 2 3 2 0 2 2 0 3 0 2 3 3 1 0 1 2 1 0 0 0 0 2 2 0 2 3 0 1 2 3 0 3 0
3  3  2  2  0  0  0  1  1  3  2  2  2  2  0  3  2  0  2  0  3  1  3  2  2  1  0  1  1  0  2  1  2  2  0  0
1  3  1  0  0  0  3  2  1  0  0  1  0  0  3  3  2  3  1  2  3  1  0  2  3  0  2  1  0  2  3  2  1  3  3  0
3  2  1  0  1  0  3  0  0  3  2  1  0  0  2  1  2  0  1  2  0  0  2  3  2  1  2  2  3  0  3  3  1  3  2  0
0  0  0  0  0  1  1  1  0  1  0  0  0  0  1  0  1  0  0  1  1  1  0  0  1  0  0  0  0  0  1  0  1  0  1  0
