3  2  3  2  3  2  3  2  0  1  1  2  3  1  3  2  0  2  3  1  2  2  0  0
2  2  2  0  0  2  3  1  2  2  1  2  1  1  0  0  3  3  2  0  3  3  1  0
1 0 3 1 3 3 3 2 3 3 1 2 3 2 2 1 1 3 3 0 2 2 1 0
022001031331303311212000
113203001011020230111120
012002210110031113211230
122322013301112012310100
002320023203230332022232
0 0 1 2 1 0 3 0 3 2 2 1 1 3 0 2 2 2 1 2 1 1 3 0
020120302210132102013100
001203212111030303101202
120022001002213202122112
0  3  2  1  0  2  1  1  1  1  1  0  1  1  0  3  0  1  1  2  2  1  3  0
303302122303122310112100
3 1 1 0 3 1 1 2 3 1 0 2 1 3 1 2 1 2 0 0 3 2 0 0
3 1 1 3 0 3 1 0 3 1 2 0 3 1 3 0 3 0 3 3 2 1 1 2
0  0  1  0  3  0  0  3  2  3  0  1  3  1  3  1  1  0  0  2  1  1  3  0
3  0  3  0  3  3  3  2  3  2  3  2  2  1  3  2  2  1  1  3  0  0  3  0
111000000011111101111110
