0 3 2 1 3 2 2 3 2 0 2 2 1 3 1 2 0 0
211203121232103302
2 0 1 3 2 3 3 0 3 2 2 0 2 0 0 1 0 0
201121022001120312
2 2 0 1 2 3 3 3 1 1 3 1 0 2 1 0 3 0
120131221031220230
0 0 2 2 0 0 2 1 0 2 3 0 0 3 3 0 0 0
1 3 2 3 0 2 1 2 0 0 3 0 2 1 0 0 1 0
0 0 3 0 2 1 1 0 3 0 2 2 0 1 1 0 0 0
2 0 1 1 0 3 1 0 1 1 3 0 3 2 3 2 1 0
0  0  1  1  3  0  2  2  0  3  2  0  1  2  0  1  1  0
301331111132202002
2  2  1  1  1  0  1  2  3  0  3  1  3  0  3  3  2  0
0  1  0  2  1  2  0  0  1  1  1  1  1  2  2  0  0  2
000110010123020100
1 3 0 2 1 2 3 0 0 2 1 3 0 2 1 3 2 0
3  1  3  0  0  0  1  1  2  3  2  2  0  2  2  1  1  2
132213013330101332
133312330102233212
0  3  2  0  1  3  2  0  0  0  0  2  3  3  1  0  1  2
1 3 2 2 2 3 0 2 2 0 0 2 3 2 3 2 0 2
3  1  3  0  1  1  0  1  1  2  0  1  2  1  1  1  2  2
3 2 0 1 1 2 2 1 2 2 1 1 2 1 2 2 1 2
101011001101001010
