2 3 2 3 3 0 2 2 1 0 2 0 1 2 0 1 2 2
211322013300001002
0 3 2 2 2 0 2 0 1 2 3 0 1 2 0 1 1 2
101311100303211232
2 1 0 1 3 2 3 0 1 2 0 1 3 2 1 0 2 0
210310030021123332
0  0  1  1  1  0  0  3  0  2  1  3  0  0  2  3  2  2
231110133320221212
3  3  3  1  0  1  2  3  1  3  2  1  3  2  3  1  2  2
3  0  0  3  3  1  3  3  3  0  0  2  2  2  2  1  1  0
321003003301333010
1 3 2 3 1 1 3 2 3 2 2 0 0 1 0 0 3 2
1  3  1  0  1  3  0  3  0  2  1  2  1  1  1  2  2  0
1 3 2 1 0 1 3 0 2 2 3 2 1 0 3 3 0 2
1 3 2 2 0 3 1 3 3 2 2 0 3 3 3 3 0 2
0  3  2  2  1  3  3  3  3  2  2  0  0  3  3  2  3  0
2  3  1  3  1  0  0  3  3  2  2  1  0  2  3  0  3  0
332032313011221330
1 1 3 3 2 3 0 3 3 2 2 0 3 1 2 3 2 2
311102002210131002
1 0 2 2 0 0 0 1 3 1 1 1 1 0 1 2 0 0
1  2  2  2  2  2  2  3  1  0  1  2  0  2  3  2  2  2
011010110100110000
