1 3 2 2 3 1 0 2 2 2 2 2 3 0 1 2
2311313110003002
2323213100223120
0123310323201310
3 2 2 3 3 1 1 2 2 3 0 0 2 0 0 2
2  3  2  2  1  2  1  1  2  2  0  3  0  0  0  2
0211230213311012
2 0 1 3 0 1 1 3 0 0 1 1 2 0 1 0
0  0  1  1  0  1  1  1  0  1  0  0  1  0  0  0
