1 3 3 3 2 1 3 1 2 0 3 2
0  3  3  1  2  3  0  1  2  1  1  0
0  0  2  0  3  0  3  1  0  3  1  2
1 1 1 2 0 0 1 0 0 0 2 2
013121231020
1  2  2  0  0  2  3  3  0  2  2  0
012031202122
221211111000
1  2  2  3  3  3  1  2  3  0  2  2
3 0 1 3 3 1 2 0 3 1 1 2
3 0 2 1 2 3 3 1 3 1 1 0
3  2  0  3  3  2  0  0  2  3  2  0
1 2 3 0 2 3 0 1 2 3 3 0
1  0  2  1  1  3  3  2  1  1  0  0
1 3 1 0 2 0 3 3 2 1 0 2
3  3  3  3  1  2  1  3  0  3  0  0
2  3  2  1  1  2  3  2  2  0  0  2
2  3  1  2  1  0  0  1  0  2  2  0
012020302300
2 2 3 0 3 3 3 2 1 2 3 2
233203010020
1  1  0  1  0  0  1  0  0  0  0  0
