221031320312100301321001033001102
200303131330222023301322122112312
312002301323321331023232013130002
011220211220300012012201301012220
3 2 0 3 1 3 3 0 0 1 0 0 3 0 3 3 3 3 0 1 1 2 3 3 2 0 3 3 3 2 3 0 2
0 3 0 0 1 3 2 3 2 2 3 3 1 0 3 0 3 2 2 1 1 0 2 1 2 3 1 3 2 0 1 0 2
3 0 1 0 3 1 2 2 1 3 3 3 1 3 2 0 1 2 2 1 3 3 3 2 1 0 3 2 0 3 1 1 2
0 1 3 2 2 2 2 3 0 0 1 3 3 0 2 1 2 1 1 1 0 1 0 3 3 3 1 1 3 2 0 1 2
132120111020112013201120000123302
133303031320302131212123330332230
3 0 1 0 3 0 0 2 1 1 0 1 1 0 2 0 3 3 0 1 0 2 0 1 3 0 3 1 2 1 1 0 2
3 1 2 3 2 1 0 3 2 1 1 3 3 0 2 2 1 2 0 0 2 0 2 3 1 3 2 2 0 3 0 0 2
220333132120021132201100321210322
231220320102000002302330311113302
1  1  3  0  3  2  0  0  2  2  0  0  0  3  2  0  3  2  2  3  3  3  2  1  1  1  3  3  3  3  1  0  0
3 3 1 2 1 2 1 0 2 2 3 0 2 0 1 1 0 2 1 3 3 2 1 0 2 1 0 3 1 0 1 3 2
030103203122200002133011313220102
032113322022100123303321111110000
122223223023323210202232123210212
0  3  0  0  1  0  2  1  3  2  1  3  2  0  1  2  3  1  2  0  3  2  1  0  2  1  3  2  1  1  0  3  2
0  3  1  1  2  3  1  3  1  1  1  1  3  2  3  3  0  1  1  1  3  3  0  2  2  0  1  2  1  0  1  2  2
232012121231230302331130132232110
0  3  2  3  3  3  0  1  2  0  0  0  3  3  1  0  0  3  1  0  3  0  2  1  0  1  0  1  2  2  2  3  0
0 0 0 0 2 0 2 2 3 1 3 2 2 2 2 3 3 3 1 2 2 3 0 3 3 1 1 2 0 1 3 2 0
202122201100033032130012323011312
001332233120130102002022132212020
1  0  0  2  0  2  0  0  2  1  3  2  2  0  1  1  1  2  0  1  1  2  3  1  3  1  1  2  0  1  3  3  0
2  2  0  2  0  0  2  3  3  3  3  1  0  1  0  0  3  2  2  3  2  0  2  0  1  0  1  2  1  2  2  0  2
0 1 0 0 1 1 0 1 1 1 0 1 1 0 1 0 1 0 0 0 1 0 0 0 0 0 0 1 0 1 0 0 0
