1031020123220031002221002030302
0 3 1 0 3 2 3 1 1 2 2 0 2 3 1 2 3 2 3 1 2 1 2 0 1 1 3 3 1 3 2
0  0  1  0  3  2  1  1  0  3  1  2  0  3  2  1  1  2  0  0  0  3  0  0  1  2  0  0  3  2  0
3  0  2  3  1  0  2  1  1  2  2  2  0  1  3  0  1  3  3  2  1  2  0  2  3  2  3  3  1  2  2
1301201330321113322331003022210
3011202232012131010213331221002
0 2 2 0 0 1 2 3 1 0 1 2 2 1 3 3 2 1 1 0 2 2 3 0 2 1 1 2 2 0 0
2  3  1  1  3  0  2  2  0  3  2  2  0  0  1  0  0  3  2  3  2  1  1  1  3  1  3  1  1  3  0
2  3  2  2  3  0  0  3  1  3  1  1  2  1  2  2  1  1  0  0  3  0  3  0  2  3  3  3  1  1  2
3 0 3 2 2 0 0 2 2 1 0 0 0 3 1 3 3 2 2 2 1 2 1 1 0 2 3 1 0 3 0
0131212010232322001001111231212
2023330320020031123101010220120
3212333302200130300030131120330
3  3  1  3  0  2  1  0  2  1  0  2  0  1  0  1  0  3  3  3  0  3  3  1  0  0  2  0  3  1  0
2001133320132030012110202222202
0111011011001001001111110101100
