3 0 1 2 3 2 3 0
31222312
3 1 0 3 2 0 2 0
02031100
3 1 1 1 2 2 3 2
20133330
2  3  0  2  2  0  2  2
1  1  0  1  0  2  0  2
13202222
1 1 1 0 1 1 1 0
