0 2 3 0 1 1 0 1 3 3 1 2 0 2 1 3 0 1 1 3 3 0 2 3 1 0 2 0 0 0 0 2 3 0
2 0 2 1 1 2 1 0 0 2 2 3 3 1 1 0 0 2 1 2 2 3 1 3 3 2 2 0 2 1 3 2 2 0
0 3 0 0 3 1 3 2 0 2 3 2 1 3 1 3 2 3 2 0 0 3 1 2 0 1 2 3 0 1 1 0 1 0
0 3 3 2 0 1 0 1 1 0 2 2 3 0 2 2 3 2 2 1 3 0 3 1 0 0 0 0 2 0 1 2 2 2
0133300032232121300023213033320032
2  1  0  3  0  1  2  0  1  0  0  2  0  1  0  0  1  0  2  1  0  3  2  0  1  3  2  0  2  1  3  3  0  0
0221123223000020032120321323021132
3310022202230230013231132323230012
2000112300102113322311222232100100
3 2 2 1 0 2 1 0 0 2 2 0 2 0 3 1 3 1 3 0 0 3 3 3 0 1 2 2 2 1 3 3 1 0
0  0  1  2  2  1  3  0  3  3  3  1  1  0  2  1  1  1  2  3  3  1  1  1  3  3  2  0  1  3  0  0  1  2
1123301111303323220313030103012120
3022101133312333231033120330223112
2322101220311210320222122300210322
2 2 3 1 2 3 0 0 2 1 2 2 0 3 1 2 2 0 3 3 3 3 1 3 3 1 0 2 0 2 2 1 1 0
3 2 3 1 1 1 2 0 0 0 1 3 2 1 3 3 2 0 0 1 0 0 1 0 3 3 2 2 3 0 0 0 2 2
0  1  0  3  3  3  0  0  2  1  0  0  2  2  0  2  2  3  1  3  2  0  0  3  3  2  3  2  0  3  3  2  1  2
2031011320331133323121111001122220
3  0  0  3  2  0  1  0  3  0  0  3  3  2  2  0  1  0  1  3  1  1  1  2  1  2  3  3  2  0  3  0  3  0
0  3  3  2  1  3  1  1  2  3  2  1  2  2  0  2  1  0  0  2  1  3  2  3  2  0  0  1  2  2  3  2  1  0
1 1 0 1 1 0 1 0 0 0 1 1 0 1 1 0 0 1 0 1 1 1 0 1 1 1 0 1 1 1 0 0 0 0
