2220233311132221313313010200312112333120
2031321111000322300130123021210013103212
1  0  1  3  1  3  0  0  0  2  0  1  0  2  2  1  1  3  2  0  2  0  0  2  0  2  1  1  1  1  1  2  3  3  2  1  2  0  3  0
0  0  1  0  0  3  2  1  0  1  0  1  1  0  3  2  2  0  3  3  2  1  2  0  0  2  2  2  1  2  0  3  1  1  3  3  0  1  3  0
2  0  2  2  0  1  3  3  1  0  0  3  1  0  1  0  2  2  2  0  1  3  0  1  0  2  2  1  1  2  1  3  2  3  1  3  2  3  3  2
2320110012012212233312330020220220222202
3  2  1  1  1  3  2  2  0  3  2  0  3  1  2  3  3  2  2  1  3  2  3  0  3  1  0  0  3  1  0  1  0  1  0  3  2  3  3  2
0  1  0  2  2  3  2  3  0  3  3  1  2  3  3  0  2  0  1  1  2  2  0  0  2  0  1  1  0  1  0  1  1  2  1  3  1  3  3  2
3 2 0 0 2 1 3 2 2 2 0 0 3 3 0 3 0 3 2 2 0 3 3 0 0 0 2 2 1 0 1 3 3 2 3 2 2 2 2 0
3 3 1 3 2 2 2 2 1 0 0 0 2 3 1 0 3 0 1 0 3 2 3 0 3 1 2 0 0 2 0 0 2 1 2 2 2 2 0 2
1 0 0 1 0 3 0 3 1 3 1 2 3 0 3 2 2 1 2 2 3 1 1 3 3 0 1 3 2 3 3 2 2 0 3 1 1 2 0 2
0  1  3  1  3  3  3  1  1  3  1  3  1  0  2  1  3  0  2  2  0  2  0  0  2  2  3  2  3  2  1  0  0  0  1  3  2  1  3  0
3 0 3 1 1 3 3 3 1 2 3 3 2 2 1 0 1 3 0 3 1 1 1 2 2 1 3 2 3 3 0 0 0 2 2 1 2 1 1 2
2123232233033020212233101200302102222210
1 1 0 1 3 0 0 1 0 0 2 0 1 1 3 0 0 3 3 1 0 0 0 1 0 0 1 3 3 3 0 2 3 3 0 2 2 1 1 2
0020021302000321330222220332211302132010
3 0 1 1 1 2 1 1 2 1 2 1 2 3 3 0 3 2 0 0 2 0 1 2 0 0 0 2 3 2 1 1 3 0 1 0 0 1 2 2
1  1  0  0  0  0  1  1  0  0  1  1  1  0  1  1  0  0  0  1  1  0  1  1  0  0  0  0  1  1  0  1  1  0  1  0  0  0  1  0
