33321311123100110210
33120221302132322110
1  3  2  3  1  2  1  3  2  1  0  2  0  2  0  1  2  2  0  0
11313130110301102010
1  2  1  2  0  0  1  0  1  3  1  3  0  2  2  1  0  0  2  2
01000021213023102312
3  0  1  0  3  3  0  3  0  2  1  2  0  1  1  0  1  0  1  0
1  3  0  0  1  3  0  3  2  2  2  2  3  0  2  2  3  0  1  0
22023330200212302012
02322111302123310330
3  2  2  0  1  2  1  1  2  1  1  3  3  1  1  3  1  3  3  2
1 3 2 1 0 3 2 0 0 0 1 3 1 3 0 1 0 1 1 2
00330100121100000132
21032102231122233300
0  3  3  3  3  2  1  3  1  2  3  1  3  1  3  0  2  3  0  2
2  0  3  1  0  1  2  2  1  0  0  3  0  3  3  1  0  0  2  2
1  1  1  0  1  0  0  1  1  0  0  1  1  1  0  1  1  1  0  0
