0 3 1 0 0 0 1 0 1 2 1 1 2 2 3 3 3 3 2 1 0 0 1 3 1 2 1 2 1 3 3 1 2 0
0  0  1  3  1  3  2  3  0  3  2  2  2  3  1  1  3  0  2  1  2  2  0  0  2  3  0  2  1  1  2  3  3  0
3  1  3  3  1  0  2  3  0  3  1  3  1  3  3  0  0  2  1  2  1  3  1  2  2  0  0  0  2  3  0  1  3  2
2  0  1  2  2  1  2  3  2  1  2  3  3  3  0  1  2  2  3  1  1  3  1  1  1  1  3  2  1  2  3  1  1  0
0  1  2  2  3  1  1  1  1  2  0  0  0  1  1  2  0  2  3  2  1  3  0  0  2  1  2  3  1  1  2  0  1  2
3220201231322233132300320301022012
0231230331310003011013131120111132
1131110221130021232012322011013322
3 0 1 3 1 2 1 3 3 0 3 3 0 1 1 3 1 1 0 2 0 0 3 0 0 0 3 1 2 3 1 1 0 0
2301103102300212302113100133011122
2  1  1  0  0  0  0  2  1  2  3  1  0  2  3  2  1  1  1  0  3  1  1  2  0  3  0  0  2  1  0  0  1  2
1 3 2 2 3 2 0 0 2 3 1 1 2 0 0 0 2 1 1 2 0 3 2 3 1 2 2 3 1 0 3 3 1 0
0122002311321210111111201121032230
3312313332223211032231232323122030
1  1  1  1  0  0  0  0  0  0  0  0  0  0  0  1  1  1  1  1  0  0  0  0  0  1  1  0  1  1  1  0  1  0
