3  3  0  2  1  3  3  2  0  1  2  3  2  3  0  2  2
12333203320002300
2 1 0 0 1 3 0 1 3 0 1 0 0 2 2 1 0
3  0  1  1  3  2  1  1  3  1  3  0  3  3  0  1  0
31132001220013202
0  3  0  1  0  3  3  2  0  3  1  0  0  1  1  0  0
0 3 3 2 0 2 0 2 0 3 1 2 0 1 1 0 2
1 1 0 3 1 0 3 2 2 0 2 1 3 2 1 0 2
11321031321100002
13123030132021022
1 3 0 0 0 3 2 0 1 1 2 1 0 2 3 3 2
1  1  1  3  3  3  1  2  0  3  0  0  1  1  0  0  0
22101010312330132
02013100223232330
21020212330133132
2  0  2  0  0  3  2  0  1  0  3  3  3  0  1  2  2
0 3 1 3 1 0 1 3 1 1 3 0 2 0 1 0 2
3  3  3  1  2  2  1  3  0  0  2  0  0  0  3  3  2
1  1  0  1  0  3  0  1  2  0  2  2  2  1  0  0  2
2  3  2  3  1  1  3  3  2  2  0  1  1  2  3  1  0
30321110323202320
0  0  1  1  0  0  2  3  3  0  1  3  1  0  1  1  0
1  2  3  2  3  3  2  2  3  1  1  1  0  1  2  1  2
12100103220211102
1 3 2 1 2 2 3 3 3 2 2 1 0 1 2 0 0
1  3  2  1  3  1  3  0  0  3  1  0  1  0  1  3  2
3 0 2 3 2 0 3 0 3 2 3 1 3 3 1 3 2
1 1 3 3 0 0 0 1 2 0 0 0 2 1 1 0 2
21230312002003322
0 0 0 1 0 1 1 1 1 1 0 0 1 0 0 1 0
