1 0 2 0 0 2 3 0 0 2 3 0 1 1 3 1 2 0 2 3 1 0 0 1 2 2 3 0 2 1 2 0 2
3  2  1  0  2  2  0  2  3  0  2  3  1  0  0  2  0  1  1  1  0  0  2  2  2  3  2  1  0  0  1  2  2
0 0 0 1 2 2 0 0 2 2 1 3 3 0 0 1 0 3 1 1 2 3 0 2 1 2 0 0 2 0 3 2 0
1 3 3 3 3 3 3 1 0 1 0 3 0 2 3 2 0 2 0 3 2 0 3 0 2 2 1 2 2 1 1 0 2
101322100112023112122300203122110
1  2  3  0  0  0  0  2  3  0  2  3  0  2  0  3  1  2  0  3  2  3  2  0  1  0  2  0  0  3  2  1  2
2 3 1 1 3 1 1 3 1 2 0 2 2 3 2 0 0 0 2 2 0 2 3 2 3 3 2 3 3 2 3 3 0
3 0 2 2 3 0 3 2 0 3 2 3 2 2 3 0 3 1 1 1 2 1 3 2 1 2 2 2 1 3 3 2 0
211013133201233101111121311031200
113110021023010103001220013103310
1  3  1  1  1  2  0  3  3  1  0  3  2  2  1  0  3  0  0  0  2  0  1  3  2  3  2  1  3  1  2  3  2
0  2  0  1  2  0  2  2  2  3  3  3  0  2  0  3  1  0  0  2  0  3  2  0  2  0  3  0  2  0  1  3  2
2  1  1  2  2  2  1  1  3  0  2  1  3  3  1  1  3  0  0  0  2  0  0  1  0  2  2  1  3  2  2  1  0
1  1  3  1  3  1  1  1  0  2  2  2  0  2  1  0  1  1  0  3  2  3  2  1  2  1  2  1  2  2  0  0  2
2 0 3 3 0 3 1 1 3 2 1 3 1 1 3 3 0 2 0 2 3 3 3 0 1 0 2 1 1 2 1 1 2
000100110100101100111111000101000
