3  1  1  2  2  3  1  2  0  0  0  2  0  1  2  3  2  2  2  2  2  0
0312313223011232101200
0003032322213202312200
2121013333312020120010
0 1 1 2 0 2 0 2 3 1 0 3 3 0 0 3 1 1 0 0 1 2
2312211101320221301220
3 3 2 2 0 3 2 0 2 3 2 3 3 3 2 2 0 1 2 2 3 2
3102210311102311021122
1  2  1  3  2  1  3  3  1  0  2  3  2  1  1  1  3  1  0  2  1  2
1 0 1 2 2 1 0 2 1 2 1 1 3 3 1 0 3 2 2 2 2 2
3 1 1 2 1 0 2 2 3 0 0 0 0 0 0 0 0 0 1 0 0 0
0200210122233211321120
2  0  1  1  2  1  0  0  2  1  3  3  2  2  3  3  1  2  1  2  1  0
2213321010220203323010
2 0 3 0 1 2 2 0 1 2 3 2 3 0 3 0 3 1 3 0 1 2
2 1 3 0 2 0 3 2 2 1 3 1 3 0 2 1 3 1 0 3 0 0
3  3  3  1  2  1  1  0  1  0  1  0  2  3  0  3  1  2  2  1  0  0
1  2  1  0  3  2  0  2  3  3  3  0  1  2  0  2  3  3  2  3  1  0
1 1 3 0 2 1 1 3 3 3 1 0 3 1 1 3 0 1 0 2 2 2
1113222120103002203110
0  0  2  2  2  2  0  0  0  0  3  2  3  0  3  2  0  2  0  1  3  2
3 0 1 0 1 3 0 2 2 3 0 0 3 3 3 2 3 3 0 2 0 2
2201103031223312000322
2320301000122112222212
2 1 2 2 0 2 0 1 2 2 0 1 2 0 3 3 0 2 3 1 1 0
1  0  1  3  3  3  2  1  0  2  3  0  3  0  1  0  3  3  3  0  1  0
3 2 0 0 1 0 0 0 2 3 1 1 0 0 3 1 0 3 2 3 0 2
0011101011100001000000
