13021010220133230030031321330
2 0 3 3 3 0 3 3 1 2 0 3 2 3 0 2 0 0 0 2 3 2 3 1 3 2 3 1 2
31323130222302302201101030102
1  3  2  3  1  3  1  1  0  2  0  2  1  3  3  3  1  3  1  2  3  2  2  0  2  2  3  2  0
21203300032301312210010012100
0 1 2 0 0 0 1 2 3 0 0 0 2 1 3 3 0 0 3 1 2 0 2 3 3 0 0 0 2
2  2  0  1  1  0  2  3  2  0  3  0  3  1  1  2  0  3  2  1  1  0  3  0  1  2  2  3  2
0 0 0 0 1 0 0 0 1 0 1 1 1 1 1 1 0 1 1 1 1 0 0 0 1 0 1 1 0
