01200313100331022330322032031301312030310
1  3  1  2  0  1  3  0  2  2  3  1  2  3  2  2  1  2  2  1  1  3  1  3  3  3  3  1  3  3  0  3  3  1  1  2  3  3  1  3  2
00022133331102101113021311111021122300132
00303213212200202211112310012212110002210
0 0 0 1 0 2 3 0 3 2 1 0 2 2 1 0 1 1 3 3 1 3 2 3 0 1 1 2 2 1 3 2 1 0 2 0 0 3 3 0 2
32322020233231333333021123023101103303200
30312202213010300330012210032312010033330
2  1  0  2  3  3  2  1  1  3  2  1  1  3  1  3  0  0  2  3  1  3  3  2  1  1  1  1  2  1  2  2  2  0  3  1  3  0  0  0  0
3 3 1 3 1 3 0 1 3 1 1 0 0 0 2 3 3 0 3 0 2 2 2 2 0 0 3 1 2 2 3 3 2 1 0 3 3 1 0 0 2
2 1 1 3 3 1 0 2 3 0 0 2 3 3 3 2 0 1 0 1 0 2 2 1 2 0 3 0 1 1 0 2 1 1 1 0 0 1 0 0 2
12020320121210300230103221200012130212310
31023301213301020022200201113301231231210
3 0 0 0 2 2 0 0 0 3 1 2 2 2 0 1 2 3 3 1 1 0 2 3 0 1 2 0 3 3 1 1 3 2 1 2 1 1 2 1 2
0  0  2  1  0  2  0  1  3  0  1  2  1  3  3  1  0  3  2  3  0  0  2  3  2  1  3  1  1  3  2  0  3  0  0  0  2  3  0  0  2
2 2 3 1 1 0 0 2 2 2 3 1 3 1 2 1 2 2 3 0 0 3 2 0 2 1 2 0 2 2 0 0 0 1 0 0 1 2 0 3 2
10301022201101312113202012320133031022010
2  3  3  3  0  3  1  0  3  1  1  0  2  3  1  3  3  0  2  3  1  0  0  1  1  3  2  3  2  0  3  1  3  0  3  3  0  3  2  1  0
0  0  1  0  2  2  3  1  3  0  2  1  3  1  0  3  2  2  3  3  0  0  0  1  2  3  3  0  2  3  1  1  3  2  1  3  2  1  1  2  2
20030203203200031203230020201320211031230
0 3 2 0 0 1 2 0 2 1 0 2 0 0 3 1 0 0 3 2 1 1 1 3 3 3 2 0 3 0 2 3 1 0 3 3 2 0 1 0 2
0  0  1  0  1  0  3  0  3  1  0  0  1  3  3  0  3  1  3  3  1  1  1  0  0  0  2  1  1  3  0  0  3  1  0  3  0  3  1  0  2
3 0 3 0 3 1 2 2 3 3 2 3 1 2 2 2 1 0 0 0 0 1 0 3 3 2 0 0 3 3 0 2 1 1 3 2 2 3 3 3 0
2  3  0  1  2  0  1  3  0  0  2  2  2  1  1  1  3  2  1  0  0  2  2  0  1  1  3  0  0  1  2  3  0  1  3  2  0  3  0  3  0
00110110011101010010001000110010011000010
