22313323120311300
2  3  0  2  3  3  2  1  2  1  1  3  3  3  1  1  0
1 2 3 2 0 3 0 1 2 0 3 2 0 0 2 1 0
0 1 2 3 1 2 0 3 2 1 2 2 1 1 0 0 0
02023322313222230
01300310023012100
3  1  2  2  1  1  3  3  2  0  2  3  1  0  1  3  2
31310233132312012
1 3 1 3 3 3 1 0 0 2 3 2 2 3 2 0 2
1 0 2 1 3 3 3 1 3 3 0 0 1 1 2 1 2
21033301013012202
00021303102120020
0  0  3  0  2  2  1  3  2  0  1  1  3  3  3  3  2
2 1 2 0 2 2 2 3 1 2 2 3 0 0 2 3 0
2  2  3  2  0  2  3  1  2  2  1  3  2  1  3  3  2
33121100221121132
00111233100003012
2  1  3  0  2  1  3  3  0  0  3  0  1  1  0  2  0
1  2  0  2  2  0  3  1  1  1  0  1  0  2  1  2  0
13221012003133030
2  3  1  0  3  0  2  2  3  1  3  0  2  1  1  1  0
23213001031133210
01122133001203330
03232030002203300
3 3 2 2 0 2 2 3 1 1 0 3 3 0 0 1 0
1  1  1  3  2  3  3  3  3  2  3  1  2  1  2  1  2
13031031032203220
10230102222112330
0 1 0 0 0 0 1 0 0 1 0 0 0 0 1 0 0
