0 3 2 0 1 1 2 2
1 1 2 2 0 0 0 0
0 2 0 1 3 1 0 0
0  0  0  2  1  1  3  0
2  0  3  1  2  2  2  0
01333002
32132130
02031110
01332212
0 0 0 2 3 2 1 0
1 2 3 2 0 1 1 2
22333322
3  1  3  3  0  3  1  2
0  0  0  0  0  0  0  0
