2 3 0 3 2 2 2 2 2 0 0 0 0
1103213232200
3  2  2  0  1  3  2  3  0  0  2  2  2
2  2  0  2  0  3  0  0  3  0  0  1  0
0020130133030
2011003320012
3223133001000
3 3 1 3 2 3 1 1 1 2 2 3 0
0203101211310
3331112102112
2212001221310
3  2  0  1  1  3  2  3  3  2  3  3  0
0  0  0  0  0  1  1  1  1  0  0  1  0
