3  1  0  0  3  1  0  2  2  0
2331022102
3  2  2  2  2  0  2  3  2  2
1300303000
3 1 3 3 3 0 1 2 2 0
0 0 1 0 2 2 2 2 0 2
1121232322
1131233020
1 3 0 3 2 1 3 2 1 0
3332301332
2 2 0 2 2 3 2 0 2 2
2 2 0 3 0 2 2 1 3 0
0 2 2 2 0 3 3 1 1 0
2 1 3 3 0 1 3 3 2 2
1  1  3  3  3  1  2  2  2  2
3 2 0 1 3 0 1 3 0 0
2122000112
2  3  3  2  1  0  0  3  1  0
2 2 1 0 2 0 2 2 0 0
2 3 0 3 0 2 3 3 3 2
0  3  0  1  2  3  0  0  3  0
0  3  0  0  3  3  0  1  2  0
2 1 3 2 0 3 3 3 3 0
2 0 3 2 2 3 2 2 3 2
0302331100
0112203212
0  1  0  0  0  1  1  1  0  0
