33222320
1 0 3 1 1 2 1 0
2 0 0 3 0 2 0 2
3 0 1 1 2 3 1 0
12222032
1  2  0  3  1  0  1  0
0  2  3  2  3  0  1  2
30233010
10131020
1  1  2  1  0  1  0  2
0 2 0 3 0 2 1 2
30110030
3 3 2 3 2 1 3 0
3 2 3 1 1 1 3 2
11331300
3  3  3  2  2  0  0  2
01001212
0 1 3 0 1 0 0 2
23322310
0 3 3 1 2 1 3 0
2  0  1  1  0  2  1  2
0  0  3  0  1  3  3  0
2 2 2 0 3 1 1 2
0 0 0 2 1 2 2 0
3 2 2 3 0 0 0 2
3  2  0  1  3  2  0  0
1  0  1  1  0  1  1  0
