3  0  3  3  3  3  3  2  0  3  0  1  0  1  0  0  1  3  0  1  1  2  1  2
2 1 2 1 3 2 1 2 0 3 3 1 0 1 2 2 0 2 2 1 1 1 0 0
3 2 0 1 0 3 1 1 1 2 2 2 2 1 1 1 3 3 3 3 0 1 1 2
0 1 3 3 3 1 3 0 3 2 3 1 1 0 0 3 2 2 0 2 3 3 3 2
1  3  3  0  0  1  3  2  1  1  1  0  2  0  1  2  2  1  1  1  0  2  2  0
102302232333001031021310
2 0 3 1 0 2 3 0 1 0 0 2 2 3 0 0 3 3 2 2 3 1 0 2
2 1 1 0 1 3 0 3 3 2 2 0 3 0 0 1 2 2 2 2 3 1 1 0
232101132123121031231322
1  0  3  0  1  3  0  3  0  1  2  0  2  3  3  3  2  0  1  1  3  0  2  0
3  1  0  1  1  2  3  1  2  2  2  3  3  0  3  0  0  3  0  3  1  3  1  0
311113311212301023301332
0 0 0 2 1 2 3 0 3 3 3 3 3 1 2 0 0 0 2 2 2 1 2 0
2 1 1 0 3 1 3 3 0 1 3 2 3 1 3 0 3 1 3 2 3 0 0 2
021012232022333103320220
3  3  1  1  1  0  3  0  2  1  3  2  1  3  3  1  1  2  2  0  3  3  0  0
1  1  3  0  1  2  1  3  2  3  3  3  0  0  3  0  0  0  2  0  2  0  1  2
3  1  1  0  3  3  1  1  0  2  2  3  2  2  0  3  1  0  1  1  1  2  1  2
2 1 3 3 0 2 0 0 3 1 1 1 3 2 3 1 2 0 2 1 1 2 3 0
1 3 2 3 0 2 0 2 0 3 0 0 0 3 1 1 1 1 0 1 3 3 1 2
1 3 1 1 2 3 0 1 0 1 1 0 3 0 0 2 2 2 1 1 2 2 2 2
1  3  0  0  3  1  3  1  1  3  3  2  3  1  1  0  0  1  0  1  3  2  3  2
331303122321330022320112
0  0  2  3  1  3  3  3  3  3  2  2  0  3  1  2  0  2  0  2  0  2  2  2
211030310231202211201202
112200312030322120301222
3  0  0  0  2  0  1  0  1  3  2  1  2  2  0  0  0  3  0  0  3  2  1  2
023221100223111211213030
3  2  1  3  0  0  0  0  0  2  0  3  1  3  1  1  1  2  0  3  1  0  0  0
1 0 0 0 1 1 0 1 1 1 0 0 1 1 1 1 1 0 1 1 1 1 0 0
