0301021013302303002310133223222
0 3 0 2 2 3 1 0 2 2 0 0 2 3 3 1 2 0 1 3 1 0 0 1 3 1 1 0 1 2 2
1  2  3  0  1  1  0  3  0  1  2  0  1  2  1  1  3  2  0  1  3  3  1  1  0  0  3  1  0  0  0
1 2 3 1 2 3 1 0 2 3 0 2 3 3 3 0 3 1 0 2 0 3 0 3 1 0 0 2 1 3 0
3  3  0  1  1  0  1  3  0  1  3  3  0  3  0  2  3  0  1  1  3  3  2  2  0  0  0  3  1  1  2
3333321212031333133120323103000
3 3 2 1 2 3 2 0 3 2 2 0 1 3 2 3 2 2 1 0 3 0 1 2 0 3 0 3 2 2 2
3 0 2 0 3 0 3 1 3 2 0 1 1 2 0 2 3 1 1 2 1 2 2 2 2 2 1 1 1 0 0
0 1 2 2 1 2 3 3 1 0 2 2 3 1 0 0 3 1 3 1 3 0 2 3 2 1 1 0 0 2 2
1 3 1 2 1 3 0 2 2 3 0 3 1 0 2 3 1 0 1 2 2 2 3 0 0 1 0 3 1 2 0
0  0  3  1  3  1  3  2  2  3  3  0  3  1  1  3  2  3  3  1  2  1  2  0  0  0  0  1  1  2  0
0003023321122233323230212330310
1 3 0 2 3 2 1 1 3 2 2 0 3 3 2 0 0 0 3 2 2 1 0 0 1 0 2 0 0 0 0
2  1  2  3  3  2  3  2  0  1  1  2  0  3  0  3  1  0  3  3  0  2  3  1  0  0  2  0  3  2  0
2  2  0  1  1  1  1  2  3  1  1  0  1  1  1  1  1  1  1  2  3  0  3  0  2  3  0  1  0  3  0
3311310313201030130200010320212
0  1  1  2  0  2  3  1  0  3  0  1  0  0  1  2  1  3  0  2  3  3  1  3  2  3  0  1  1  2  2
1  1  2  0  1  0  3  3  3  2  3  0  0  3  1  3  1  1  1  1  0  1  0  3  2  3  0  0  1  1  0
2  2  1  0  0  0  1  3  3  3  1  1  0  3  2  1  1  2  3  1  2  2  0  2  3  1  3  0  1  1  0
2  3  2  0  1  1  2  3  1  0  0  0  2  0  2  2  1  2  2  1  0  2  1  2  0  1  2  3  1  1  2
3233103101210221100033200223010
3  3  1  0  0  3  2  2  3  1  3  0  1  3  3  3  3  2  2  1  2  2  1  1  1  3  2  0  3  0  2
0222211110220033111021022123012
0  3  0  2  1  3  0  2  0  0  1  3  1  2  3  3  0  3  3  0  2  1  1  0  2  2  1  0  3  3  2
3  3  0  0  3  0  2  2  0  1  1  0  0  1  1  0  1  3  2  1  3  2  1  2  0  1  3  2  1  0  2
3  2  0  1  3  1  3  3  3  3  0  1  1  1  3  3  1  3  0  0  0  2  3  1  0  3  0  1  3  1  0
0012031300020020212012213232000
1 3 0 3 1 1 2 3 1 3 0 3 2 3 0 0 0 1 3 1 3 2 2 3 2 0 1 0 3 1 0
0233013111311230010200301312010
2032121213300101210030101220012
0000100100010100001000001010010
