2 0 1 1 2 2 1 1 2 2 1 0 0 3 0
3  1  2  3  1  2  2  3  1  1  0  0  1  1  0
0  2  3  0  3  3  1  1  1  3  2  1  1  0  0
121111212230212
113110213023100
0 1 1 3 0 3 1 3 3 3 3 0 1 2 2
2 0 3 2 0 1 1 0 3 3 3 1 3 3 2
321110211022102
1  0  2  0  0  0  3  2  1  2  2  0  2  3  0
2  0  1  1  3  1  2  1  1  2  0  0  1  3  0
203302212011030
2 1 3 1 3 3 3 1 1 1 1 0 0 3 2
2  3  2  2  0  1  2  3  3  0  2  3  2  0  0
1 0 1 2 1 2 1 0 2 0 3 2 1 1 2
331233123212010
1  3  0  2  3  1  0  0  3  3  2  3  2  2  0
3 0 1 1 3 0 2 0 3 0 2 2 2 0 2
0  2  2  1  1  0  2  3  0  0  0  1  1  1  0
1  0  3  1  0  3  0  1  3  3  0  1  2  1  2
111011011011100
