3 1 1 3 2 0 3 1 0 3 3 2 2
3 2 0 1 3 3 1 3 0 2 2 3 2
2030202031330
0 2 2 1 0 0 0 0 1 3 1 2 0
2233131103300
0  0  2  1  0  3  3  3  3  2  0  1  2
2 0 0 0 3 2 1 2 3 1 3 3 0
0 1 0 2 1 3 3 3 2 0 2 0 2
2 3 2 0 0 2 0 1 0 3 2 2 2
0102310032220
0  0  3  2  3  0  1  1  1  0  1  1  0
0023223221100
2  0  0  2  3  2  0  3  0  3  2  1  0
0 1 2 0 0 0 3 3 0 1 0 0 0
1311131122312
0032200030112
1202222220120
2  3  2  2  2  2  0  1  1  3  2  2  0
1203303013302
0 3 2 3 1 3 0 2 3 1 0 2 2
0000113323210
0013320311232
1 1 2 1 3 3 1 2 1 1 2 3 2
2 2 2 0 1 3 2 1 2 0 3 2 0
0 3 0 3 1 0 3 2 0 1 1 2 2
3  1  3  0  1  3  3  0  0  2  0  0  2
1 0 0 1 0 0 1 1 0 0 1 1 0
