33033202322
1 3 1 1 3 1 0 0 3 2 2
0 0 3 3 2 3 1 2 3 0 0
11232010202
3 0 3 1 3 3 1 1 0 1 0
30001121002
3  2  2  3  1  3  1  3  0  3  0
3  2  3  1  1  1  2  2  1  1  2
3  2  0  0  2  0  3  2  2  3  0
13131003332
00321003120
2  1  2  0  3  1  1  1  0  2  0
2 3 1 3 0 2 1 3 1 1 0
30330123020
01221120212
13202310100
1  1  0  2  0  2  1  2  3  0  2
11021303010
10033101210
0  3  2  2  1  2  3  3  1  0  2
2 1 2 1 2 2 1 1 1 1 0
0  1  1  0  1  1  0  0  1  0  0
