2  0  1  3  1  0  3  1  0  3  1  1  1  0  3  0  1  1  1  1  3  2  0
1  0  3  3  3  0  1  0  3  3  0  2  1  1  1  0  3  2  1  0  2  1  0
0 3 0 2 2 1 2 0 2 1 0 3 3 0 3 1 1 2 0 1 3 3 0
22330302222323121211212
0  0  3  0  2  2  0  1  3  3  1  1  2  3  1  0  0  1  1  0  3  1  0
3 3 0 0 0 0 2 2 0 2 0 1 1 3 2 3 2 3 3 3 2 3 2
3 3 0 2 2 1 0 1 0 2 1 1 1 3 1 0 2 0 0 0 2 0 0
13122020230322301000020
0  1  2  2  3  1  3  1  2  2  1  1  2  3  3  2  1  1  0  1  3  2  0
12233300012300011102022
3 1 2 1 0 1 1 3 1 3 0 1 3 1 3 1 1 2 0 2 3 1 0
2  1  1  2  1  2  2  0  2  1  3  0  1  3  1  1  0  3  2  3  3  1  2
21300212102203322030030
00311102003112331122002
2 3 1 3 2 3 2 2 3 3 3 0 0 3 3 1 0 2 1 2 1 1 2
1  2  3  2  3  2  1  0  2  0  2  0  2  3  0  0  1  0  2  0  2  3  0
1 1 2 0 0 3 0 3 3 3 1 2 3 0 2 0 3 3 2 1 1 1 0
20110332302010112130332
1 0 3 2 2 0 0 2 1 0 1 1 2 1 0 2 1 1 0 2 0 3 2
21221213113032120202320
00333212121021301122200
0  0  1  2  1  2  0  3  3  2  0  2  1  1  2  2  2  0  3  0  0  1  2
0  3  0  1  1  3  1  0  2  0  2  2  0  1  1  1  3  3  1  2  0  3  2
01303002320033202131302
32322301321330221030232
31132333311311330211212
0 1 3 1 2 2 0 2 1 2 3 3 2 0 3 2 1 2 1 3 2 3 2
0 1 1 0 1 1 0 0 1 1 1 1 0 1 1 0 0 0 0 0 1 0 0
