3 0 1 0 3 1 1 2 1 1 2 1 3 2 1 1 0 0 0 3 2 1 1 0 0 2 2 0 2 2 2 2 2 2
3  2  3  1  1  1  2  0  3  0  3  0  1  3  2  2  0  0  2  0  3  2  0  0  0  3  3  1  0  2  2  2  2  2
2  3  1  3  3  3  1  1  1  3  2  2  1  0  0  2  1  1  0  3  1  0  1  0  1  1  0  3  2  3  1  0  1  0
1 2 1 3 3 0 3 2 2 3 0 0 2 3 0 1 2 1 2 3 0 3 1 2 3 2 3 3 2 0 2 3 0 2
0 2 2 3 0 1 0 2 1 1 2 0 2 2 3 0 1 2 1 3 2 3 1 3 0 1 2 1 3 0 2 2 2 0
2 0 2 2 0 2 3 2 2 1 2 1 1 3 2 3 3 1 2 0 3 3 3 3 1 1 2 0 3 3 1 0 2 0
2022223201030201003313211010003202
1213210303021031233233000021023120
3  1  3  3  1  3  3  1  3  1  2  0  2  2  0  0  2  1  0  1  2  1  3  1  2  3  0  2  3  0  3  1  2  0
3 3 2 3 1 0 0 1 1 2 1 2 0 3 0 0 0 1 2 0 3 1 3 3 3 1 0 1 0 3 1 0 1 2
3  1  2  1  1  1  0  2  2  2  0  0  0  1  2  0  3  3  0  3  1  3  3  3  2  3  2  0  2  3  0  2  1  0
3 0 2 3 2 2 0 0 3 3 0 3 0 3 3 2 0 3 0 1 2 2 1 2 0 0 0 1 2 0 3 2 0 0
1  0  0  2  3  2  2  2  1  1  3  2  2  0  3  3  1  3  3  2  0  1  2  0  1  0  0  2  3  1  0  3  3  2
2 3 0 1 3 1 2 0 0 3 1 1 2 2 1 3 0 0 1 0 3 1 2 3 3 2 3 2 1 3 3 2 2 0
0 3 0 2 2 1 2 1 0 0 3 0 3 3 2 1 0 1 3 3 2 0 1 0 2 2 3 1 0 3 1 3 0 2
0 1 2 2 0 1 3 2 3 0 0 2 1 0 3 2 1 1 0 1 3 3 3 2 2 2 2 1 1 2 2 1 2 0
3 1 1 0 0 2 2 2 0 2 1 3 2 3 0 0 2 1 2 1 3 0 3 3 0 0 1 2 1 3 3 2 2 2
0  0  0  2  3  0  3  2  0  1  3  1  2  0  1  3  1  3  3  3  3  1  1  2  3  0  2  3  1  0  2  1  3  0
2232011122003033312233310003011212
1121010013121101311231121200123202
3301113312021010031231010313322120
0 3 0 1 0 2 1 2 3 1 1 2 1 0 1 2 1 2 1 2 3 1 0 1 3 3 3 3 3 3 1 3 3 0
2  3  3  2  0  2  1  3  0  3  2  3  2  2  3  0  2  2  1  3  3  0  2  2  0  2  1  1  3  3  2  1  2  0
3  1  3  2  0  1  0  1  1  3  1  3  2  3  3  1  1  2  2  1  1  3  0  0  2  3  0  3  0  0  3  2  2  2
1231030121311123123113210133223120
3220102013310110310101033030013300
1100011101001010111100101111110110
