3031313132101322101020003121232200310302
1 1 1 1 1 2 0 0 2 0 1 3 3 0 1 3 0 1 1 3 3 2 1 3 2 3 0 1 3 2 1 0 1 1 2 2 2 2 3 0
2232311320320323333130231210220310321122
1 0 1 0 3 2 3 1 3 3 1 0 0 2 0 3 1 3 3 0 2 3 1 3 3 0 3 3 1 0 3 0 3 3 3 0 2 1 1 2
3 2 2 1 2 3 0 3 3 2 2 3 3 0 1 0 2 2 0 2 0 2 0 3 0 2 2 0 1 2 2 3 1 0 0 1 3 2 1 0
1 0 0 2 2 3 3 3 2 1 1 0 0 3 3 1 3 3 0 0 3 3 2 0 0 2 3 0 2 1 2 1 3 1 1 3 0 0 0 0
1  1  2  1  0  3  3  0  3  2  0  2  2  0  3  0  0  3  0  1  2  2  2  2  0  3  1  3  0  0  1  1  2  0  2  1  3  1  3  2
1321021100112223332100013123230303202220
0132200310020302030300200333231200230130
3  3  0  3  1  1  1  1  2  3  2  3  3  1  0  0  1  3  3  2  1  1  1  3  0  3  2  3  3  0  0  1  1  0  2  1  2  3  1  2
2130223222320001100211112102223012302330
1  3  2  2  3  3  2  0  3  0  2  2  0  2  0  3  1  2  2  2  0  1  2  1  1  1  2  1  3  0  1  3  0  1  1  1  2  0  1  0
0 1 2 1 1 1 1 2 2 0 0 2 3 2 3 0 3 3 3 2 3 3 1 2 2 3 3 2 2 3 1 3 0 0 3 1 0 3 3 2
2  0  3  3  1  1  1  3  2  1  0  2  0  0  2  1  1  2  2  0  0  0  3  1  0  1  1  2  2  0  0  1  1  2  3  2  1  0  1  2
2203232212012002230232133301000213233300
1  2  2  0  1  0  0  1  1  3  1  2  0  2  2  0  2  0  0  1  0  0  3  2  2  3  2  3  1  2  3  3  2  3  1  2  3  0  3  2
1  2  3  2  3  1  0  0  2  3  1  1  1  2  2  1  1  3  2  0  3  1  2  3  0  0  1  3  1  1  1  3  3  1  3  2  1  3  2  0
2 3 0 1 3 1 1 0 3 3 0 1 1 2 0 3 1 2 2 3 1 1 2 1 1 1 2 1 3 1 3 3 2 3 1 3 1 0 0 0
2  1  0  3  3  0  3  3  0  2  2  0  2  2  2  1  0  1  3  1  0  1  1  1  0  2  1  3  2  2  2  3  2  2  3  1  3  2  1  0
2033030313333001310120312001231301100102
0 1 1 1 3 2 3 1 2 3 1 0 2 1 1 3 1 0 3 1 3 1 1 2 0 0 3 0 0 1 0 3 1 3 2 3 1 2 3 2
0132330222333231223323320213001322213322
0 1 0 0 0 0 1 1 1 0 1 0 0 1 1 1 0 0 1 1 1 0 1 0 0 1 1 0 0 0 0 0 0 1 1 1 0 1 1 0
