00132203302012030221001010
01023300331222122300032012
2 0 1 3 0 1 0 1 0 0 0 1 3 3 0 0 3 2 2 0 2 2 0 1 0 2
1 2 1 0 3 0 3 1 1 2 0 0 0 1 2 1 3 3 3 2 1 3 0 2 2 0
3  3  0  0  3  3  1  2  2  0  3  3  0  0  0  3  0  2  1  3  0  0  0  1  3  2
3  3  1  0  2  3  0  2  2  1  3  2  0  2  2  1  1  2  0  2  2  2  1  2  3  0
3 1 0 1 2 1 3 2 2 0 1 2 0 3 1 0 2 2 1 2 3 3 3 1 1 2
2  2  2  1  0  3  3  3  0  3  1  2  0  2  0  1  0  2  1  2  0  0  0  1  0  2
23103100312022002332011102
22112232113302212110022332
01130203333111300313331122
2  3  0  0  0  2  3  1  2  3  0  1  3  3  3  1  1  1  0  1  3  3  3  0  1  2
0  1  1  1  0  2  2  2  3  0  2  1  1  0  1  3  0  1  2  1  1  3  3  2  0  2
2  1  2  1  3  0  3  3  0  2  1  0  2  2  2  2  1  1  1  0  3  3  2  3  1  0
2 0 3 0 0 0 0 1 1 2 1 1 2 1 1 0 2 0 2 3 2 2 2 2 3 2
02223011221011000321023302
1 0 2 1 2 2 1 0 2 2 1 0 0 3 1 1 0 0 3 0 2 1 3 3 3 2
3  1  2  0  3  3  0  1  2  3  0  0  2  0  3  1  0  1  2  3  2  0  3  0  0  0
11003303021023123233012110
20101223030212303102132022
23212313323203223210210032
33130202303030333211023212
2  3  1  2  3  1  0  1  0  1  2  1  1  2  3  1  0  3  1  0  3  0  0  1  0  2
1  2  3  1  3  0  1  0  0  0  0  3  0  0  3  2  1  0  0  3  3  0  1  2  2  0
3 0 0 2 0 0 1 2 1 1 1 1 2 0 2 0 0 2 3 2 3 0 2 3 0 0
1 1 1 0 1 1 1 0 0 1 0 0 1 1 0 0 0 0 1 1 1 1 1 1 0 0
