0  1  1  0  1  2  0  0  2  0  0
23103322112
1 2 1 0 2 3 0 1 1 2 0
1 0 3 2 1 3 0 1 1 1 0
2  0  3  2  2  0  1  3  3  0  2
32300100012
30232030100
02101031002
3  0  1  2  1  0  3  1  2  1  2
12011232120
21220331022
2 0 1 3 2 2 1 1 3 1 0
00212203122
2 0 2 0 2 0 2 2 0 2 2
0 2 1 3 1 2 3 0 1 0 0
10221221320
1  3  3  3  3  3  3  2  2  3  0
1 3 0 1 1 3 3 3 0 0 2
3  2  2  0  3  2  3  3  3  1  0
30033113212
01001101100
