3 1 0 0 2 1 3 2 1 0 0 3 3 0 0 1 2 2 0 1 0 0 3 3 3 3 1 2 0 3 0 2 0 2
0132023203120121132131221311213322
0321213303003331222203121222133330
1 2 3 2 2 0 3 0 0 2 1 0 0 2 1 3 0 1 1 1 2 2 2 3 2 0 2 1 0 3 1 3 0 2
1223232113133010220233120312132112
3 1 3 3 0 0 1 1 1 2 3 3 0 2 2 1 0 2 1 2 3 0 1 1 3 2 3 3 1 3 2 0 2 0
3 3 0 1 1 2 3 2 0 1 0 1 3 1 0 0 2 3 1 1 0 0 3 3 2 2 3 2 3 1 2 1 0 0
3 3 3 2 0 0 0 2 2 0 1 0 0 1 3 1 1 1 1 0 0 3 1 0 1 0 2 0 3 2 0 1 1 2
3001111310000310333121303322131102
0233122303013132103130111211132230
1 2 3 3 0 2 2 0 0 1 2 1 1 0 1 0 0 0 3 2 0 1 0 2 1 2 2 1 3 1 0 3 3 0
3332302101003311022331312102020330
1300312321320321120102002031320320
0 1 1 1 0 1 1 0 0 1 0 0 0 1 0 1 1 1 1 0 0 1 1 1 1 1 1 0 1 1 1 0 0 0
