202220121001031303300
320310111230212212210
0  0  1  0  3  0  2  0  3  2  0  2  1  1  1  3  2  3  3  1  0
020220002221310312020
333021321012320032010
203133000323103131132
120312320031323213020
032321131030020331330
2 0 1 0 0 0 3 1 2 1 3 2 3 2 1 0 1 1 1 0 0
0 1 2 3 2 2 2 1 3 1 2 1 0 2 2 1 2 0 0 0 2
3  1  1  1  2  0  3  0  1  1  1  0  2  3  0  0  1  2  2  3  0
320333221301123310002
202203322300211223010
1  1  2  0  2  2  1  1  2  3  2  0  3  1  0  0  2  2  0  1  2
2 1 3 3 2 2 2 2 0 3 3 3 0 0 0 2 2 1 3 2 2
1  3  1  2  1  2  1  2  3  0  1  1  2  3  3  0  1  0  0  0  0
0  2  1  2  2  1  2  0  3  0  1  0  2  3  0  0  2  1  3  3  0
3  0  3  2  3  2  1  2  2  3  0  3  2  2  1  3  1  3  2  1  0
1 1 0 2 3 3 1 1 0 1 0 2 2 0 2 0 3 1 0 2 2
310020210332002020200
2 1 1 3 3 2 3 1 2 1 3 1 0 0 2 2 2 3 2 0 0
0 2 3 1 3 1 1 3 1 3 2 1 3 0 3 2 2 1 2 2 0
133331331233133200012
001000000000100000110
