2 0 2 1 1 1 3 3 3 3 2 1 3 0 3 3 0 0 0 1 1 0 0 3 0 3 1 3 2 3 0 2 3 3 3 0 2
2  2  2  2  3  2  3  0  0  0  3  2  1  3  0  0  1  0  3  3  0  1  1  3  1  3  1  1  2  3  0  0  1  1  3  1  2
3  3  3  1  3  1  2  3  0  3  3  2  0  3  0  2  2  1  0  3  2  3  0  1  2  1  3  2  0  2  3  3  2  0  0  1  0
2 1 2 1 1 0 1 0 2 1 3 2 3 3 0 2 3 3 2 2 1 3 3 0 1 2 2 3 3 0 1 2 2 2 1 0 2
2  2  2  0  1  1  3  0  1  1  2  3  1  1  0  1  3  2  2  3  2  1  1  3  3  1  2  1  3  2  3  2  0  2  2  1  2
1233332033212331212033233202211230230
1213102302000203211323211230030013322
0 3 1 3 2 0 3 2 0 3 3 0 1 1 0 1 1 1 2 3 1 0 2 0 0 1 1 1 1 1 3 3 1 0 0 1 0
2  1  2  1  2  0  3  2  3  0  0  2  0  2  3  2  3  2  1  3  1  1  0  2  3  0  0  1  1  2  0  2  0  2  2  0  0
3 2 3 0 1 0 2 3 3 2 2 0 0 2 1 1 2 1 1 1 3 3 0 3 1 0 0 0 0 0 0 1 2 2 1 1 2
2  2  3  1  0  3  2  1  0  1  1  2  2  2  1  2  2  2  3  0  1  2  1  1  3  1  3  1  2  2  3  0  0  3  2  1  0
1001023030123233132112323323231123220
1  2  2  1  3  1  3  3  2  2  0  1  2  1  2  0  3  3  2  3  3  0  2  0  3  1  0  0  1  3  1  3  3  2  2  1  0
2  3  1  2  0  3  3  1  2  0  2  3  3  2  2  0  2  1  1  3  2  2  0  2  3  0  0  1  1  3  0  0  2  0  2  1  0
3032302223103222302111203203001130330
2 2 2 1 2 2 0 1 3 2 3 2 2 2 3 2 3 0 3 3 1 2 0 2 2 2 0 1 3 0 2 2 2 3 0 3 2
1112210222112130222221110213113011132
3310021121030102333231033332030301012
3  0  3  3  3  3  1  3  0  2  3  0  1  1  2  3  1  0  1  0  0  2  2  2  2  3  2  3  0  2  1  1  0  1  3  1  0
2311011302102331331132123003101031232
0 0 0 3 1 3 2 3 1 0 2 3 3 1 2 2 2 0 1 3 2 3 2 1 3 3 1 3 1 1 1 2 3 2 3 0 2
2  3  0  3  1  0  3  0  1  2  0  1  3  1  3  2  3  2  2  1  1  0  0  1  2  2  1  1  3  1  2  2  2  0  2  3  2
0122103213033302322313333312102202320
0 0 0 3 1 0 0 0 3 3 1 3 2 1 0 2 3 2 1 1 3 3 0 3 0 3 3 0 3 3 0 2 3 3 1 3 0
3  2  0  3  2  2  1  2  0  2  0  2  1  1  2  3  0  3  2  1  0  1  2  0  3  1  1  0  2  1  3  0  3  1  3  3  0
3203121000102302312102001110132301002
2  1  3  1  1  2  2  1  1  0  3  3  2  0  0  2  2  1  2  1  3  2  1  1  1  2  1  1  2  3  1  1  2  2  3  1  0
2  2  2  1  1  3  2  2  2  2  3  0  0  2  0  0  2  0  2  2  3  3  1  3  1  0  1  3  0  1  2  0  2  0  0  2  0
2  1  3  0  0  1  0  1  1  0  2  1  2  0  3  2  3  0  0  3  1  3  3  2  2  3  0  3  2  0  2  0  1  1  3  0  2
0 0 0 0 1 1 1 1 0 1 0 1 0 0 0 0 0 1 0 0 1 0 0 0 0 1 1 0 1 1 1 0 0 1 0 1 0
