3 0 1 2 1 1 1 3 3 2 0 0 2 1 2 2 0 1 0 0 3 3 0 1 3 0 2 0 0 0 1 0 0
3 1 1 3 3 1 2 1 3 3 2 2 0 1 3 0 3 0 0 3 0 3 0 0 2 3 0 2 1 3 3 1 2
0 2 0 0 2 2 3 2 2 3 2 0 1 3 0 1 0 0 0 1 1 1 3 2 3 0 1 3 0 3 2 1 2
0  3  2  1  2  3  3  3  3  3  1  0  3  0  2  1  0  3  1  0  3  2  0  1  3  0  0  0  3  2  0  3  0
120001110123212111112331331133030
3 2 2 2 0 3 3 3 0 2 3 3 1 3 3 2 1 0 0 0 0 1 1 3 2 0 1 3 2 1 2 3 0
1  3  1  3  1  2  1  0  0  1  1  2  2  2  0  2  1  3  3  0  1  3  3  3  1  1  2  1  3  0  1  3  0
1  1  0  2  1  2  1  1  1  2  2  3  3  1  2  3  2  3  3  1  3  0  2  1  0  1  1  2  3  1  3  3  2
1  2  2  0  2  2  3  2  3  0  3  2  3  1  3  0  3  3  1  0  3  2  0  2  2  2  1  0  0  0  3  3  0
2  0  1  0  1  1  2  0  1  3  0  0  0  2  1  0  1  3  0  1  2  1  3  0  0  1  0  1  2  2  0  0  0
2  1  0  2  0  3  0  3  2  3  2  2  0  1  1  2  2  0  0  2  3  0  3  1  3  2  2  0  0  3  2  0  2
033113132202011001002111222331232
0 3 0 2 2 2 2 0 0 3 1 2 3 2 0 0 1 3 2 2 2 1 3 1 1 1 2 0 2 1 2 2 2
0  1  2  3  2  3  1  1  1  3  2  0  1  1  3  1  1  2  3  2  1  0  3  3  0  2  3  3  0  2  3  2  2
2  0  1  0  1  0  1  1  3  2  1  2  1  0  0  1  2  1  2  1  3  2  2  2  3  0  3  3  3  3  2  2  0
3 0 3 2 1 0 3 0 0 2 3 0 1 0 3 1 0 0 0 3 1 2 1 0 2 3 1 3 0 0 2 3 2
122220122033132123021202033122332
3  0  0  1  2  2  3  3  2  2  0  3  0  3  3  1  0  3  0  3  3  2  1  2  0  2  1  1  0  2  3  1  0
3 0 3 1 2 3 1 3 1 1 2 2 0 3 0 2 1 1 3 0 2 1 0 2 1 3 0 3 0 1 3 0 0
013320100311212132300311220312302
013322123133033113021201031202112
133013223230112323200131200202222
2  0  1  0  3  3  0  3  3  0  0  2  3  2  0  3  1  0  1  1  1  2  3  1  2  3  3  0  0  1  3  2  2
1 0 0 1 1 0 0 0 0 0 1 0 1 0 1 1 0 0 1 1 0 1 0 0 0 0 1 0 1 0 0 0 0
