02333221122133023223212201320112
2  0  0  3  1  1  2  2  1  1  0  3  2  2  1  0  3  2  3  0  1  0  2  0  3  3  2  2  3  2  0  2
1 3 0 3 3 1 0 3 2 0 2 2 3 3 0 0 1 3 0 1 1 0 1 1 3 1 1 3 1 0 0 0
2  3  1  2  2  0  2  3  0  0  1  1  3  0  2  1  2  1  1  0  1  1  0  3  1  2  1  0  3  3  2  0
3 1 0 0 2 3 1 1 3 0 2 1 2 1 2 2 1 1 0 0 1 1 2 1 2 2 2 3 2 2 2 0
0  3  1  1  1  3  0  2  3  0  2  0  2  2  0  0  2  1  2  0  1  2  1  0  2  3  0  3  2  1  0  2
3 1 3 2 1 3 3 0 2 2 3 3 0 1 0 0 0 2 3 3 3 0 0 1 3 2 0 2 1 1 0 0
33102302133113220011300221312022
32031030000122030120133303332332
03211112110201203320012302211320
11212031112122122032312132203330
01031130001011231103330010223032
33101332122122010021203113112032
03221330011210110221301221033002
3 2 0 1 3 0 2 3 2 3 2 1 2 0 1 1 0 1 3 0 1 3 1 0 1 3 2 0 0 2 2 2
32321100110222320303303123002100
10122122323112020110112010012320
0 2 1 1 3 0 3 1 1 0 1 2 2 0 3 3 3 3 2 0 3 2 1 0 2 1 0 2 0 0 0 2
13000022111223213131033021301200
2  0  3  0  3  1  1  0  0  1  3  0  0  1  1  3  1  3  3  2  3  1  3  3  1  2  3  1  3  2  3  0
3 0 3 3 0 2 1 3 0 2 1 0 2 0 2 0 3 0 0 2 2 3 2 1 2 2 1 2 1 0 2 0
30222320122003320223101322032112
21212200013303103023311233102300
00203233111023310200310301120130
2  2  1  2  0  2  3  0  0  1  1  0  3  2  1  0  0  1  1  1  1  3  1  3  2  0  2  0  3  1  0  0
31013211322123021101121211332202
3  0  3  3  2  1  1  2  2  1  2  3  1  1  3  1  0  1  1  2  0  3  1  0  1  0  1  1  3  0  0  0
23000003322012311301012013303132
10000000110010010110001001010000
