3  0  0  0  1  2  2  0  3  3  2  2  1  3  0
0 3 3 3 0 1 1 2 2 1 3 1 3 2 2
030001022211110
0 1 0 0 0 2 1 1 3 1 0 3 3 3 2
313111112233130
1 1 1 2 2 2 3 2 3 2 3 3 2 0 2
3  1  2  3  1  3  0  1  1  3  0  0  1  2  0
2 2 0 2 2 2 2 1 0 2 0 1 2 1 2
3  2  2  3  2  0  3  2  1  3  0  0  2  1  0
321130011212000
1 3 3 2 3 1 1 3 3 2 2 2 1 2 0
2 0 3 2 0 3 3 3 2 1 1 1 0 3 2
233101303300022
223330021012022
3  1  2  3  0  3  1  2  2  2  2  2  2  2  2
1  1  0  3  2  0  3  1  1  1  0  1  1  2  0
3  1  1  3  3  1  2  1  2  2  1  1  2  0  2
022321031033010
222201231021010
0  1  2  1  3  1  1  3  0  3  0  0  1  2  2
0 2 1 3 2 3 0 2 1 3 3 0 1 1 0
1  1  1  1  1  0  1  0  1  0  1  1  0  0  0
