0 2 3 0 0 0 3 3 0 2 1 3 0 3 1 1 3 1 2 3 0 2 1 3 1 2
03233311313222003033210200
3  1  1  2  3  0  3  1  0  2  0  1  3  1  3  2  1  1  1  2  3  1  1  0  0  0
0 3 0 2 0 1 1 3 3 1 3 1 1 0 1 2 0 0 1 3 1 2 2 2 0 2
3 3 0 2 1 0 3 1 0 0 2 0 0 1 1 3 1 1 2 1 1 0 1 3 1 2
11210320101031012130320332
0  0  2  2  2  0  1  1  3  0  0  1  3  3  0  0  0  2  0  1  3  0  1  0  3  2
23330212123113222031111010
00210212000233110202111200
32133000120033212231020312
1  2  1  2  3  3  1  1  1  2  0  1  2  2  1  2  3  2  2  2  2  1  1  2  0  0
2  3  2  3  2  1  3  2  1  2  0  1  2  0  2  3  3  0  3  2  2  2  1  3  0  0
3 2 2 3 1 2 3 2 0 1 1 2 0 3 3 3 1 3 2 2 2 0 2 3 3 2
1 2 1 1 2 2 2 3 0 0 0 2 2 3 1 2 1 1 1 1 0 0 1 3 0 2
0 3 1 1 3 0 3 1 0 2 3 2 2 2 1 1 1 0 0 1 0 3 1 2 1 0
32033202303210330210121232
1  0  0  1  1  1  0  0  0  1  1  1  0  0  1  0  0  1  1  1  1  0  1  1  1  0
