0032013012302131000201330002012
0233233000212000301202303200300
2  3  3  2  1  0  3  3  0  3  3  3  1  2  0  3  3  0  3  1  1  2  2  3  1  0  2  3  1  2  0
1  1  1  0  2  2  0  1  3  1  2  3  0  1  3  3  1  0  0  3  1  3  3  3  1  0  2  1  0  3  0
1 1 2 3 1 0 3 1 0 1 0 1 2 1 3 3 1 0 2 1 0 2 1 2 0 2 0 2 1 1 0
0 0 2 2 3 0 0 1 2 1 1 1 3 0 0 1 1 2 1 0 0 0 0 2 3 0 3 0 0 2 0
3 0 2 0 3 0 1 1 2 3 3 0 2 2 1 3 0 1 0 3 3 0 1 1 3 2 3 1 1 3 2
0  2  1  1  3  0  0  1  1  3  0  1  1  2  0  1  2  3  2  0  2  1  0  0  1  2  3  2  1  2  2
0 3 2 3 3 0 3 0 0 3 3 1 2 2 1 0 1 3 3 0 2 0 2 1 3 0 0 2 1 1 2
1230223203120231300300222013100
0 0 2 3 3 3 2 1 2 3 2 3 3 3 0 1 1 1 3 3 1 0 2 1 3 2 3 2 3 2 2
1 3 3 3 0 0 0 3 0 0 2 0 2 2 2 0 3 0 2 1 1 1 1 0 3 0 2 3 0 1 2
1330223223001033221212212003222
1021333023111303331310233133230
2  3  0  1  2  3  1  2  0  0  2  2  0  3  0  1  0  0  2  0  1  1  1  1  2  0  3  3  3  0  0
2  0  3  0  0  0  0  3  0  0  2  1  2  2  2  3  2  2  0  2  1  2  2  3  2  2  0  1  3  0  2
1  1  0  1  0  0  1  0  0  0  1  0  0  1  1  1  1  1  0  1  1  0  0  0  0  0  1  0  0  1  0
