0 3 1 1 0 1 3 0 1 3 0 2 2 0 0 2 0 0 1 2 2
213231202011310333202
3 3 2 3 3 1 0 3 2 0 3 3 3 0 0 2 3 1 0 3 2
0  1  0  1  2  3  1  3  0  3  0  3  1  0  1  3  0  3  3  0  2
332100330132102113322
323312331212313112310
3  3  2  1  1  1  2  0  0  2  1  1  2  2  2  0  1  0  2  3  2
013023333320021231022
3  1  2  3  2  2  3  3  1  0  2  0  1  3  3  0  0  0  1  3  2
3  3  3  3  0  2  0  1  0  1  0  0  3  3  2  2  0  3  1  2  0
001111101111111001010
