2312332002223131130
0132201112220232002
2  2  2  1  3  0  2  2  1  1  1  1  3  0  0  0  1  0  0
2  2  2  1  0  2  0  3  2  0  3  3  1  1  1  1  2  2  2
1 1 1 3 0 0 3 3 0 3 3 3 0 2 2 2 0 0 0
2  0  3  3  2  2  3  1  1  3  3  1  0  2  2  1  3  2  0
1  1  0  3  2  3  2  0  3  3  2  0  2  3  3  1  1  0  2
3031230101122031202
1 0 3 3 0 2 2 0 3 0 1 3 3 3 2 0 2 1 0
0200011131132123030
0 1 1 0 2 1 0 2 3 0 0 2 1 3 3 2 0 2 2
0 1 3 0 1 0 2 0 0 2 2 3 1 2 3 0 2 1 2
3  1  0  1  1  1  1  3  1  0  0  3  1  3  2  3  3  0  0
3130001020233001322
0 1 1 0 2 3 2 0 1 2 1 0 1 0 1 1 2 2 2
1310303333132310120
0222200313221120312
0221111102311322210
3 1 3 3 0 3 1 3 3 1 1 3 2 2 2 1 0 1 0
0 1 3 2 2 0 2 0 2 1 1 1 0 2 0 1 1 2 2
1110112201103021230
2 2 1 2 1 3 3 3 0 0 2 0 3 0 1 2 1 3 2
3320300002200113122
1012310211123120232
2201323023003322332
1  0  0  1  1  0  0  1  0  0  0  1  0  0  0  1  1  0  0
