2  0  3  3  0  2  0  0  1  1  3  0  2  0  2  0  0  1  2  2  2  0  1  1  3  0  1  1  1  3  2  1  2  2  2  0  2  1  3  0
2  0  3  0  1  0  1  1  2  0  0  3  2  1  1  0  0  1  2  0  0  2  1  2  2  3  2  0  2  2  3  1  2  3  3  1  2  3  1  0
1122020210001211323033232013012030221330
3213222310110122103323110220300010110220
1 0 3 0 0 1 1 3 1 1 3 3 0 1 2 1 3 0 3 1 2 3 3 0 0 0 2 1 3 2 2 2 0 2 1 2 3 2 1 0
0  2  0  1  1  0  1  3  2  1  1  2  2  1  1  0  3  3  1  3  3  0  2  0  1  0  3  2  1  1  1  1  1  2  1  3  1  1  0  0
1 3 3 3 0 0 3 3 0 2 3 0 3 2 2 1 3 2 1 3 1 2 1 2 1 3 3 0 0 0 1 2 1 1 3 3 3 3 0 2
0  1  2  2  1  0  3  0  0  1  1  3  3  2  0  2  3  0  1  0  1  1  2  0  3  2  1  1  1  1  1  2  3  2  3  3  2  2  1  2
1  1  0  2  2  0  0  0  0  0  1  1  1  3  2  3  0  1  3  0  0  3  1  3  0  1  2  2  2  3  0  3  3  1  2  0  0  3  3  2
2 0 0 3 1 1 1 2 3 1 1 3 2 0 3 2 1 2 2 0 1 3 3 2 1 3 3 2 1 2 2 1 0 0 2 2 2 0 1 2
2 3 0 3 3 0 2 0 0 1 3 2 2 0 3 0 0 1 3 0 0 3 1 1 2 1 1 1 1 2 0 0 2 2 3 2 2 2 2 0
1101201233101003222231320100202321032212
1  1  3  0  1  1  0  1  2  3  2  0  3  2  2  3  3  2  0  1  2  1  1  0  3  0  2  2  1  1  2  0  0  3  2  0  3  3  2  2
1 1 2 0 2 0 3 1 2 3 3 0 1 1 0 3 3 1 2 1 2 2 0 0 3 3 1 0 0 2 0 2 2 2 3 2 0 0 0 2
2330031111313102031201132313012333133022
0320321312302103030131131330112210320100
1001011111101011011111100010100001010100
