313231220331001011310
3  2  3  2  2  3  3  1  0  0  1  0  1  3  0  0  2  3  2  2  2
333311031231212100230
0  3  0  3  1  0  0  3  1  2  2  2  1  3  3  2  3  0  0  0  2
1 2 3 0 0 2 0 3 3 0 0 3 3 2 2 1 1 2 1 2 0
0  1  1  2  3  0  0  2  0  1  2  3  3  0  0  3  3  0  0  1  2
1 0 1 2 0 1 1 2 0 3 1 3 1 2 0 1 2 3 1 3 2
331101013220120233210
3  3  3  2  1  3  2  3  0  2  0  0  2  0  0  0  0  3  1  3  0
3 2 1 0 1 3 2 0 0 0 2 0 2 1 1 3 0 3 1 1 0
3  2  1  3  2  3  2  3  0  1  1  3  2  0  1  1  0  1  1  0  2
2 1 3 0 2 1 1 2 0 3 2 0 2 3 0 2 1 2 1 0 0
312122030032021121032
3  1  3  2  0  1  2  2  0  1  0  1  2  1  2  0  1  2  2  2  0
320212003220201020030
220211030033233303330
0 0 3 2 3 3 0 3 3 2 3 2 3 3 0 1 3 0 3 2 2
1 1 3 0 0 1 2 0 1 2 3 1 0 2 3 3 0 3 0 0 0
3 2 1 0 0 1 3 3 1 0 2 0 0 2 1 2 2 2 1 2 0
223333210200323031320
0 2 0 2 0 0 3 0 0 3 2 2 2 0 0 3 0 0 1 3 0
3 2 2 2 3 3 3 3 3 2 2 2 2 1 2 1 1 1 3 2 0
3 1 1 1 3 0 2 1 3 0 1 0 1 2 1 1 0 2 2 3 0
0 1 0 3 3 2 2 0 2 0 3 3 1 0 0 1 1 2 3 3 0
2 0 1 2 3 3 2 0 1 1 1 1 0 2 1 0 2 3 1 2 0
0 1 2 0 0 0 1 2 0 1 0 0 3 0 2 2 0 0 3 0 0
021123213321010210300
300132033130131300210
132023313221010213212
0  1  0  1  1  0  0  1  1  0  0  0  0  0  1  1  1  1  1  1  0
