121033120331023311131112110002020030230
3 2 3 1 3 1 1 1 3 1 3 2 3 3 1 3 2 1 0 3 2 3 0 0 0 2 3 0 1 3 3 0 2 1 0 2 3 3 0
1  2  0  1  3  3  2  0  1  2  0  1  2  1  1  3  2  2  1  2  0  3  1  3  3  0  0  1  2  0  3  2  1  2  2  0  3  1  0
2  3  0  0  2  0  3  1  3  3  3  0  1  3  3  1  3  3  2  3  0  1  2  1  3  1  1  0  1  0  0  1  0  1  2  2  2  3  2
3 2 2 3 2 1 2 3 0 2 1 0 1 0 2 2 0 0 3 3 1 2 0 1 3 0 2 1 0 3 3 3 3 0 1 1 1 2 2
0 1 1 3 3 2 3 0 3 1 3 0 2 0 0 2 1 2 1 1 3 1 1 3 1 0 3 1 3 1 3 3 0 1 3 3 3 0 2
232133130112211220323321211021321123210
3 1 0 3 0 0 2 3 3 2 3 0 1 0 3 0 2 2 1 1 1 3 0 1 2 2 2 1 1 2 0 2 3 1 1 3 2 2 0
1  3  1  2  2  2  2  0  3  2  2  2  3  2  0  3  0  3  0  2  1  3  0  0  2  3  0  0  0  0  2  2  2  1  2  1  0  1  2
333210021023310332120313123133100132210
3  3  2  0  2  3  2  1  3  1  1  0  3  3  1  2  1  3  2  3  3  0  0  2  2  0  1  2  0  1  3  2  1  2  0  1  1  0  2
2  3  2  0  0  3  0  0  2  1  2  0  1  0  1  3  0  1  3  3  2  3  1  0  3  3  1  2  3  1  2  2  2  3  0  0  1  2  0
102003233101203202300000331122311222310
013031311011200133012030003012201223122
1  2  1  0  3  0  3  3  1  3  2  3  0  1  2  3  3  0  3  0  0  3  1  1  3  3  3  0  0  1  1  3  2  1  2  2  2  0  2
1  2  3  0  1  0  3  0  2  2  1  1  0  0  3  3  2  0  3  0  2  2  2  0  2  2  2  0  2  3  0  2  2  2  3  2  0  0  0
2  0  2  0  2  3  2  1  3  3  2  0  1  0  1  3  2  1  3  3  0  3  1  2  3  1  0  2  2  0  1  1  1  2  1  0  3  3  0
1  1  1  1  2  0  0  1  3  3  3  2  0  3  1  2  0  0  3  2  0  3  3  2  2  2  1  1  2  3  1  1  3  2  1  2  1  1  2
1 0 1 2 2 3 1 2 2 0 3 1 2 3 3 0 3 2 2 1 1 0 0 3 0 0 0 3 1 1 0 2 3 0 2 0 3 3 0
0 1 3 3 1 2 3 1 2 1 0 1 0 1 0 2 2 2 1 3 3 3 1 2 0 1 2 2 0 2 1 2 2 3 1 1 3 0 2
3  2  3  2  3  3  0  2  0  3  3  1  0  0  0  3  2  2  1  0  0  1  3  3  1  3  1  2  0  1  3  3  2  3  0  3  1  2  2
020301320002010013233233122030331313012
203033032301332113023233023222110001122
0 1 0 0 1 0 1 1 1 0 1 0 1 1 1 0 1 0 0 0 0 0 0 1 0 0 1 1 0 1 1 1 1 0 1 1 1 0 0
