0 0 1 2 1 3 2 1 3 0 0 3 2 2 2 2 2 3 2 2 0 0 0
2 1 2 3 1 0 2 0 1 2 0 2 0 2 2 3 1 3 3 3 3 2 2
1 2 1 2 2 3 3 1 1 0 0 2 1 3 0 0 1 1 3 2 0 2 2
3  1  0  2  3  3  2  3  2  2  1  1  2  3  0  2  3  1  0  2  3  3  0
3 1 1 1 3 1 1 3 1 3 2 1 0 0 0 2 1 0 2 1 0 3 0
2 2 0 0 3 2 2 0 0 3 1 1 1 3 1 3 0 0 2 3 1 2 0
2  1  2  3  2  2  3  1  3  1  0  2  3  2  2  1  2  3  0  2  2  2  2
12102012303131001311332
1  3  0  3  0  1  2  2  3  0  2  3  2  3  1  2  1  2  1  2  0  0  0
33220222220133133130220
22023103323202211312030
11001122213000222033120
0  3  1  2  3  1  0  1  1  2  3  2  0  0  3  3  3  3  1  2  2  2  2
0  1  0  3  1  1  1  3  3  3  0  0  2  1  0  0  3  2  1  1  0  3  2
2  2  1  2  1  0  1  0  2  2  3  0  2  2  3  2  0  3  3  3  3  0  0
0  0  1  1  0  1  3  2  3  0  0  3  1  1  0  1  0  0  3  2  0  2  2
00312101312003323103130
3  3  2  3  1  2  0  0  1  0  0  3  3  0  3  1  0  3  3  0  1  2  2
33132000000312021012330
1 0 1 1 3 1 1 3 1 3 2 3 0 1 1 1 1 1 1 2 2 2 2
12310100131020101223110
31022120213231131111300
1  3  0  1  1  1  2  2  1  1  3  3  0  3  3  3  2  3  1  3  0  3  0
0  0  1  0  0  0  1  1  0  1  0  0  0  1  1  1  1  1  0  0  0  0  0
