0  0  3  3  1  3  2  3  1  0  2  1  2  0  0  1  2  2  1  0  1  3  0  0  3  1  0  1  2  0  0
1  2  1  2  1  1  3  0  3  2  2  3  3  1  1  3  3  2  2  2  2  0  0  1  1  3  3  0  1  2  0
1  1  1  1  1  1  0  0  1  0  3  3  0  1  0  0  2  2  3  2  1  3  3  0  1  0  2  1  2  1  0
1  3  0  0  0  0  0  0  0  2  0  2  3  3  1  3  2  1  1  3  0  1  3  3  3  1  0  0  2  2  2
3121221311000002331201222120002
3  1  0  2  3  1  2  0  0  2  2  0  1  1  2  0  3  3  2  3  3  3  1  0  1  0  3  0  2  3  2
2 2 0 0 3 1 2 2 3 0 3 3 3 2 3 3 2 3 0 2 3 3 0 1 3 1 3 1 3 2 0
3312200103113132302212031123120
1  0  1  1  1  2  0  0  3  0  1  3  0  2  0  3  0  3  1  1  0  0  3  3  3  3  2  3  1  2  0
3200021013200322330101200312320
0  2  1  1  3  2  1  3  1  1  2  0  1  1  1  0  0  0  3  0  2  3  1  0  1  3  1  1  2  2  2
2  2  1  2  0  1  3  2  3  2  3  2  1  3  3  1  3  1  3  3  0  0  3  2  1  3  2  2  0  2  2
0  1  2  0  0  2  2  2  2  0  0  1  3  0  3  0  3  3  0  2  2  3  2  2  2  0  2  0  1  2  0
0 3 0 2 1 1 0 3 3 1 0 1 2 0 1 3 2 0 1 0 2 0 3 2 2 0 0 0 3 0 0
0  2  1  2  3  3  3  0  3  0  2  0  0  0  0  0  1  0  3  1  3  1  2  3  2  1  0  0  0  2  2
0011022331232022010323201101210
3  1  0  2  3  2  2  0  1  3  2  0  1  3  3  0  1  0  2  0  3  3  3  2  3  1  1  3  1  2  0
3233102111013331112202231233022
3  3  3  2  2  2  1  2  2  1  0  0  2  2  2  0  3  1  1  3  2  1  1  1  1  3  0  0  3  2  0
0300231133203101030213223022032
3002200010210112003203300203332
1203223213313231003021223223002
1101001101110001000100011100110
