3  0  0  0  1  1  3  2  3  2  0  3  0  3  2  3  2  3  2  0  1  1  0  3  0  1  3  2  0  3  0
1  0  1  1  1  1  2  0  1  2  2  1  3  2  3  1  0  0  3  0  3  1  2  1  3  3  0  0  3  1  0
2 2 1 3 1 3 1 1 2 0 1 1 3 2 0 2 3 3 0 3 1 1 0 3 2 1 1 3 1 0 0
0 1 1 0 1 0 1 3 2 0 1 0 1 3 1 2 0 0 1 3 2 3 3 3 2 0 3 3 3 2 2
1  0  2  2  0  3  0  0  2  1  3  0  3  0  0  2  3  3  1  3  3  1  0  0  2  2  3  3  3  3  0
1  2  1  0  0  0  1  0  2  2  1  2  2  2  0  0  2  3  0  3  3  2  3  3  3  0  1  0  0  3  2
3132133321122103321233203031122
1 0 0 2 1 2 2 0 0 0 1 3 0 1 0 1 2 0 0 3 1 3 3 0 3 0 3 1 3 0 2
1 3 2 1 0 1 2 3 1 1 2 1 3 2 1 3 2 0 1 3 0 2 0 0 3 2 1 2 2 3 2
0221002302130330221213230332232
1  2  1  1  1  0  3  3  1  2  0  2  1  0  2  1  3  2  0  3  1  1  1  1  1  0  3  0  2  2  0
2  0  2  3  3  3  0  2  2  1  0  3  0  1  0  2  1  3  0  0  0  3  2  0  0  0  0  1  1  1  0
1  2  3  2  0  1  0  1  2  3  3  1  3  2  2  1  0  0  0  1  2  1  0  2  1  3  3  1  0  0  2
3  1  2  2  1  3  1  0  1  0  1  3  1  3  2  1  3  2  2  2  2  0  3  0  0  1  0  3  3  2  2
1 3 1 2 1 0 2 3 3 2 1 0 2 3 3 1 0 1 1 0 2 1 2 1 0 1 3 1 3 0 2
3033332102211322113223233121010
2  3  2  2  1  2  3  2  0  3  1  0  3  0  2  2  2  1  3  3  3  2  1  2  0  2  0  1  2  2  0
1  2  1  1  2  0  0  3  0  0  0  3  3  2  0  2  1  3  1  0  3  1  2  3  1  1  3  1  0  0  2
0101212021010002212211331100212
2320022121233233231022100200120
2  3  1  2  3  2  0  0  3  0  3  2  2  3  2  0  1  3  0  2  2  3  1  2  1  3  0  3  0  0  0
2 3 3 2 1 0 2 0 3 1 1 2 2 0 0 0 0 2 1 3 3 3 3 1 2 1 0 3 0 3 2
2021213312022100331020131013020
2  0  1  0  1  2  2  0  1  3  3  0  0  0  3  2  1  1  0  3  2  2  1  1  3  2  3  2  2  2  2
2102311003113032132302310202232
1  0  3  1  3  0  0  0  0  2  0  3  0  0  0  1  0  2  0  2  1  0  3  0  0  3  0  2  3  3  2
3030201033220112330320101001000
1 2 3 3 3 2 3 0 3 1 0 3 1 1 3 3 1 3 1 2 1 1 3 0 0 1 2 3 2 2 0
1  1  1  0  0  1  1  1  1  0  0  0  1  1  0  0  1  1  0  0  1  1  1  0  0  0  0  0  0  1  0
