3  1  1  0  0  2  1  1  3  2  2  0  1  0  1  2  3  2  0
2330133021021302202
2  3  0  1  0  1  1  3  2  2  1  0  0  0  2  2  3  3  2
0232323133000332130
3  0  2  2  3  0  2  2  0  1  0  3  1  1  1  0  2  2  0
0 1 0 1 3 0 3 2 2 3 1 0 2 1 1 3 3 2 2
3  3  3  0  1  1  1  0  1  3  2  1  1  0  2  0  2  0  0
3032303232203320102
2 2 0 3 0 3 2 0 0 1 3 1 1 0 3 3 0 2 2
0  0  2  3  2  3  3  1  3  2  2  2  1  1  2  2  1  1  0
2  3  2  0  2  0  2  1  2  2  2  2  2  3  1  3  0  3  2
3  3  1  2  1  0  1  2  0  2  0  0  2  2  1  3  1  1  0
2 3 1 0 1 2 1 3 2 1 3 2 3 3 0 3 2 2 0
3  3  2  0  0  2  3  0  1  1  3  1  1  0  1  0  1  2  0
3  1  0  0  1  0  0  2  2  3  0  3  0  3  3  1  3  0  2
0  1  1  2  3  0  2  3  3  2  3  0  3  0  0  3  2  0  2
0123131031031120300
0  1  0  1  0  0  1  0  0  0  1  0  0  1  0  0  1  1  0
