1  0  1  3  3  3  3  1  0  0  1  0
1 3 2 2 0 3 0 3 1 0 0 0
1  0  0  0  2  0  2  0  1  0  3  2
212233110100
1 2 2 2 0 2 0 1 3 0 0 0
1  2  3  1  1  3  1  2  1  0  3  0
223330120120
0 3 3 1 2 2 0 2 2 0 3 0
201222101132
230013103130
210230332022
3 2 3 2 2 0 3 3 0 1 2 2
032223110300
3  0  2  3  3  2  0  0  2  2  2  2
333112203110
2  2  0  1  0  2  2  3  3  2  3  2
3  3  2  3  3  2  1  1  3  1  0  0
332130200222
2 1 3 3 1 3 1 2 3 3 2 2
2 1 2 0 2 1 3 0 3 0 2 0
302222323310
0 0 2 2 1 1 3 2 1 2 1 2
103221021002
011001010100
