3  1  2  0  0  2  0  3  0  0  3  3  2  3  3  1  2  0  1  0  2  2  3  3  0  3  1  2  3  0  2
0  0  1  2  1  0  2  3  2  2  1  3  2  2  3  1  1  0  0  0  2  3  1  2  3  3  2  0  2  2  0
1  2  0  1  1  3  0  2  2  3  1  0  0  2  0  1  2  2  0  3  3  2  1  0  1  1  0  1  3  2  0
1132021100130210211112311303200
3 0 2 2 1 2 0 3 3 3 2 2 3 1 0 0 3 1 2 3 3 1 1 3 1 0 1 0 3 1 2
0203100011003323221023012111310
3  0  0  3  1  3  3  1  1  2  3  3  3  3  3  1  2  2  1  3  3  2  0  1  2  0  2  0  1  2  2
2  1  0  3  2  3  2  3  1  0  0  1  2  3  2  3  0  0  1  3  1  2  2  3  2  3  0  2  3  2  2
0 0 1 1 2 2 3 0 1 0 3 1 2 2 0 0 0 2 2 0 0 1 3 0 0 0 3 0 0 0 2
0  1  3  3  0  1  1  1  0  3  3  1  3  0  2  0  2  2  1  1  1  1  0  0  0  1  1  3  0  1  0
0220000011213113333222322212202
2300202010013010231011132333112
0 0 3 1 0 1 2 0 2 3 2 1 1 1 2 1 1 1 0 0 2 2 1 3 0 3 3 3 0 0 0
1  0  0  0  0  1  0  1  1  1  0  1  0  0  0  1  0  1  1  0  1  1  1  0  0  1  0  1  1  1  0
