1  2  3  2  3  1  1  2  1  0  1  3  2  2  0  3  3  3  2  0  0  0  3  0  2  3  0  3  0  3  0  0  1  0  3  1  3  2  2  1  0
0 2 3 1 0 2 0 0 2 1 2 0 1 0 0 3 0 1 3 0 2 3 3 3 3 0 3 2 0 0 1 3 0 0 0 1 2 0 1 2 0
2  3  1  3  3  3  1  1  0  1  3  0  1  0  0  1  1  0  3  3  2  3  3  0  0  3  2  1  3  3  2  1  1  1  2  1  3  3  0  3  0
2 2 2 0 0 2 2 1 3 3 1 2 2 3 0 3 2 0 0 3 2 2 0 0 0 3 3 0 0 2 0 2 3 0 3 1 3 1 1 3 2
03321132102111112013211331321201232033220
3 0 3 1 1 3 1 2 0 1 3 3 0 3 3 0 0 0 0 3 1 3 2 2 1 3 2 3 3 1 0 2 1 2 2 2 0 2 3 2 2
0  3  0  3  2  0  3  3  2  3  2  0  0  0  0  2  2  1  2  2  3  2  2  2  1  3  2  3  1  2  3  0  2  3  3  0  0  3  1  3  2
0  0  0  1  3  0  0  2  0  0  1  1  2  2  1  3  2  0  2  2  3  1  1  1  3  2  2  0  0  3  2  3  2  2  2  1  2  2  1  2  2
30133312000002210012331021233123331100302
1  3  2  3  0  0  3  1  1  0  2  1  1  0  3  3  0  3  0  2  1  2  3  0  2  0  2  2  2  2  3  1  1  2  0  0  3  2  0  1  2
1  0  2  3  1  3  3  0  3  0  3  1  0  2  1  2  3  3  2  2  1  3  1  0  0  2  3  2  0  1  0  3  1  1  2  1  0  2  0  2  0
0 1 0 0 2 0 1 2 2 0 0 1 3 1 0 0 2 1 0 3 0 1 2 0 1 2 2 3 3 0 3 2 2 3 3 1 3 0 0 3 0
3 1 1 3 0 3 1 1 1 3 2 2 3 3 2 1 0 1 0 1 3 0 0 0 3 3 2 1 2 0 3 0 2 1 2 3 0 1 0 3 2
1  1  3  1  0  0  1  0  0  2  0  2  3  3  1  0  1  3  3  1  2  2  3  2  1  2  1  0  2  0  3  1  2  3  0  3  2  3  0  3  0
1 2 2 3 1 0 3 1 2 0 1 1 0 3 0 3 1 2 0 3 0 1 0 2 1 1 2 3 2 1 2 0 0 0 3 3 3 2 1 3 0
1  3  1  0  3  1  1  2  1  1  3  0  2  2  2  3  2  3  0  2  0  0  0  1  2  2  3  2  1  3  0  1  3  1  3  1  1  0  2  3  0
23131320323110133203001130013021011111030
2  2  0  1  2  1  0  2  3  2  3  1  0  3  2  2  2  0  2  3  1  1  3  3  3  1  0  0  2  1  2  3  0  2  3  3  2  1  2  0  0
32221301310312223323222132330113322103102
0  3  2  0  3  1  2  3  2  1  1  1  1  3  1  2  1  0  2  3  2  1  2  0  0  1  0  0  3  1  2  0  3  0  0  0  3  3  0  1  2
3 1 3 3 2 3 0 3 0 0 1 0 1 2 1 0 0 1 1 2 1 0 2 3 2 3 1 2 2 1 0 0 1 1 1 2 1 2 0 1 0
10000321033320110220133222313112013010020
11101100010001000001011101011010011110000
