2130230021322
0 0 2 1 1 1 1 1 0 1 2 0 0
1001102120130
0100131033310
2 0 2 3 1 2 0 3 2 3 3 0 0
1  1  2  1  1  2  3  0  0  3  1  0  2
2302210322000
3  2  0  0  3  1  3  1  1  3  2  0  0
0  1  1  1  0  0  2  3  1  0  2  0  2
1030303002322
3  2  1  3  0  2  3  3  1  2  2  3  2
3 2 3 3 0 3 3 3 3 0 1 0 2
1202210002030
3 2 2 1 2 3 1 0 0 3 3 3 0
1  1  1  1  0  0  1  1  0  0  0  0  0
