3  3  2  3  2  1  0  1  0  2  3  1  1  1  2  3  1  0  1  1  0  0  0  3  3  1  3  0  2  0  3  3  2  2
2  3  2  3  0  3  1  3  3  2  0  2  1  1  3  2  0  2  1  1  3  2  2  3  0  2  2  1  3  1  3  1  3  0
3 1 3 0 2 2 2 2 3 2 0 0 2 1 3 0 1 2 2 3 0 0 0 3 0 1 1 2 0 1 1 0 1 0
3  1  1  2  1  2  0  2  2  0  0  3  0  3  3  1  1  1  0  0  1  1  1  0  2  3  3  2  1  2  3  1  3  0
1  2  3  1  2  3  0  0  0  3  1  1  0  2  3  3  3  1  2  2  1  0  0  1  0  3  0  1  1  0  3  2  1  0
1 0 3 1 3 0 3 0 3 3 3 0 1 0 0 3 3 0 1 3 2 3 3 0 3 0 0 1 0 2 0 2 1 2
2 2 0 1 1 1 3 3 2 3 2 1 0 2 1 2 0 3 2 3 2 2 3 1 3 0 1 3 1 3 2 3 2 2
3  0  3  2  0  1  1  2  2  3  1  3  1  3  1  1  2  3  2  2  0  2  0  0  3  1  0  2  3  3  3  0  0  0
0 1 2 3 3 0 3 1 1 1 2 2 3 1 0 1 3 2 2 2 0 2 0 0 0 0 1 2 0 2 0 2 3 0
3120230032100022200131131323203122
3  2  1  0  1  0  1  1  0  0  2  0  2  1  1  0  0  2  0  1  0  3  1  2  3  1  2  2  3  3  0  1  1  0
0  3  0  0  2  0  2  0  1  3  3  3  0  2  1  0  0  3  0  1  1  3  1  3  3  1  1  1  2  1  1  0  0  2
0301001002130102312311312313122102
3  2  0  3  0  3  1  2  0  1  2  0  1  0  0  3  0  2  2  3  2  1  0  0  2  0  2  2  0  3  2  2  0  0
2  0  2  3  2  2  2  0  3  0  0  3  3  1  3  2  0  0  1  1  2  2  3  3  3  0  3  1  2  0  1  3  0  0
2  0  2  1  3  3  3  3  1  3  2  3  2  2  0  0  3  2  0  0  2  0  0  2  2  0  2  1  3  2  0  1  2  0
2 0 2 1 0 1 0 2 1 0 3 1 1 2 3 3 0 3 1 1 2 3 2 2 2 1 0 0 1 0 0 1 1 2
0 3 0 3 1 2 1 1 2 0 0 3 3 0 0 2 2 3 0 1 1 3 2 3 3 0 3 1 3 2 3 3 0 0
3  2  1  2  1  0  1  1  1  0  1  3  3  2  2  3  3  3  3  2  3  2  2  1  0  0  1  0  2  0  3  2  3  0
0103323031300103311311302303123200
0 0 0 2 0 3 1 0 0 2 1 0 3 0 3 0 1 3 3 3 0 2 1 1 0 2 1 0 3 2 1 3 1 0
2  0  2  2  2  1  0  2  1  2  0  3  3  3  0  0  0  2  1  1  2  1  0  3  2  2  0  0  1  0  2  0  0  2
1003120002103130330331311030311332
2 0 2 0 0 3 0 3 0 2 3 1 0 3 0 0 0 2 2 0 0 0 0 0 1 3 1 1 3 1 2 3 2 0
1112023110122321002321113212021010
1  0  1  3  0  2  2  0  2  0  3  2  3  2  2  3  1  0  1  0  1  2  3  0  2  3  1  2  2  3  3  0  0  0
0  1  0  0  0  0  0  0  1  1  1  0  1  1  0  0  0  0  0  1  0  0  0  0  1  1  1  0  1  1  1  1  0  0
