0  3  0  3  3  1  2  0  2  1  1  1  0  2  0  2  0  2  3  2  1  1  0  1  1  2
3 2 2 3 0 1 2 1 1 1 1 0 0 2 3 2 1 0 1 2 3 2 2 2 2 2
2 2 0 0 0 2 2 3 1 1 0 0 1 3 3 1 0 3 0 2 3 0 3 0 0 0
1  1  2  0  0  3  1  0  2  0  1  1  2  3  1  2  3  2  0  0  0  2  0  0  3  2
30010003123100221303221000
1  2  0  2  3  1  0  2  2  0  3  2  1  3  0  3  1  1  2  2  2  0  1  1  2  0
2  3  0  2  3  2  0  2  2  3  2  0  1  3  0  0  2  3  1  2  0  0  2  2  3  0
0  3  1  2  3  3  2  1  2  0  2  3  0  0  3  2  2  0  0  3  1  1  2  1  3  0
2  3  1  0  1  0  3  2  3  1  2  3  0  1  0  1  3  0  2  0  2  0  1  1  3  0
1 2 3 0 1 1 3 0 0 3 3 3 3 1 0 0 3 1 3 0 2 0 1 3 0 0
02033330312213031132032320
0  3  3  2  2  2  3  2  2  3  2  2  2  1  1  0  0  1  2  0  1  2  1  1  0  0
2 3 2 2 0 0 0 3 3 3 2 2 1 1 3 3 3 3 2 2 2 1 2 3 3 2
0  2  1  1  2  1  1  0  3  1  1  3  2  1  0  3  3  3  0  0  2  0  1  1  2  0
0  2  3  0  0  3  2  1  1  1  3  1  2  3  1  2  2  2  3  0  1  3  1  0  0  0
0 1 1 0 1 0 1 1 3 3 0 2 1 2 2 1 2 1 0 1 2 0 1 1 0 0
32012122303032222031200132
1 3 0 1 3 0 2 0 0 0 1 2 1 2 3 1 0 2 0 3 3 1 2 3 0 0
31113212231011320302301122
1  1  0  1  3  2  3  1  0  0  2  2  1  1  2  3  0  1  0  0  2  1  3  0  0  2
2  1  2  2  3  3  0  3  1  3  0  2  1  2  1  3  1  2  2  3  1  1  0  2  2  2
0 2 0 1 1 2 3 0 0 1 2 1 0 3 2 3 3 2 1 2 1 0 3 1 1 2
3 3 3 0 1 2 0 0 0 2 0 3 2 3 1 0 3 3 1 2 2 0 3 1 3 0
21101232211002332130322212
33222031312022331333230202
1 3 3 0 2 2 2 2 2 2 0 1 0 3 3 1 2 1 1 3 2 2 1 2 3 2
30113300123220320132033112
2  2  2  0  3  2  2  2  1  0  2  2  2  0  1  1  1  2  1  1  0  2  0  3  1  2
3 3 1 1 3 1 2 3 2 2 2 2 0 0 0 0 0 3 0 2 1 3 3 0 2 2
1 2 1 3 0 1 1 3 3 1 2 3 0 0 3 1 0 1 0 1 3 0 3 2 1 0
1 1 1 0 0 0 0 0 0 1 0 0 1 1 0 0 0 1 0 1 1 0 1 1 1 0
