02203320130203130310010
3 2 2 3 0 2 0 0 1 2 2 2 0 2 1 2 2 2 3 0 1 3 2
00210121333230321311322
3  0  3  3  2  0  0  2  0  1  1  1  3  1  0  1  2  1  3  2  1  0  2
1 1 2 3 2 3 3 2 0 2 2 3 0 2 0 1 3 2 1 3 1 0 0
21012212323312030022332
3  1  1  2  1  0  0  3  1  3  1  2  1  0  0  2  1  1  1  1  3  1  0
3 1 3 0 0 3 0 3 1 0 1 3 0 3 3 0 1 3 3 3 3 2 0
3 2 1 0 3 3 2 2 0 2 2 0 2 1 3 3 0 1 0 3 3 3 0
10222223101300132002302
20323221232203013210030
32012021120222311333120
1  1  1  1  1  1  0  3  0  1  0  3  1  0  1  3  3  0  1  1  0  2  0
03220231103200303131012
21333021102330222103222
12123300300013201323232
0  2  3  1  1  0  2  3  1  0  1  0  0  3  3  0  3  3  1  3  1  2  0
0  0  3  0  1  0  1  1  0  1  3  0  3  2  3  3  2  2  3  1  2  1  2
1  1  2  2  2  0  0  0  1  2  1  2  1  0  2  1  0  2  2  2  1  0  0
0  0  0  1  1  0  1  0  0  1  0  1  1  1  0  1  0  1  0  0  1  1  0
