13000313330
11310213030
21320200322
11302021002
00002132312
01002122000
30222112312
3  0  1  1  3  0  3  3  2  0  0
0 1 0 0 0 0 0 1 0 1 0
