2  0  3  0  1  3  0  2  3  3  2  1  0  1  3  1  1  0  1  2  3  0  3  2  0
0 2 3 0 0 1 3 3 2 3 3 3 0 2 2 0 2 1 1 1 3 0 3 1 2
3  3  3  1  2  1  2  2  2  2  2  3  2  0  2  3  2  1  1  1  2  1  0  1  2
0202013110221302031320022
1  0  3  2  3  0  3  3  2  3  3  0  1  1  3  1  3  3  0  1  2  2  1  3  0
2 0 0 2 3 1 0 0 3 0 1 3 3 0 1 1 1 0 1 0 3 0 3 2 0
3013320002310033003101222
3 2 0 0 1 0 0 3 2 3 2 1 1 1 2 1 1 1 1 0 3 3 0 3 2
2010303011002002202122132
1 2 1 1 1 3 0 3 2 1 2 3 1 2 2 2 3 2 1 0 0 3 2 2 2
1  0  3  2  0  0  0  2  3  1  1  2  0  2  0  2  3  0  2  0  2  0  1  2  0
3 0 3 2 3 1 1 1 2 0 1 2 0 2 1 2 2 1 3 3 0 3 1 2 2
1000110310310103013121112
3  3  2  2  0  0  1  3  3  1  1  0  2  3  0  2  3  0  2  3  2  2  2  0  0
2  2  2  1  1  3  0  3  2  3  0  1  0  2  2  2  2  3  0  1  1  2  3  3  2
1231120010020112312220130
3033312303133312320302122
3 2 2 0 3 2 3 3 0 1 3 1 1 3 2 2 3 1 1 0 3 1 1 2 2
3  2  3  1  2  2  3  2  3  0  3  2  3  1  2  3  3  2  1  2  2  3  0  3  2
1003001022312332303201132
2 3 1 3 1 1 1 0 0 3 3 2 2 2 1 3 1 1 3 3 1 0 0 1 2
3  1  2  2  1  0  0  0  2  2  0  1  1  3  3  1  3  0  3  0  2  0  1  3  0
1 1 2 1 2 1 2 0 0 2 1 1 0 0 0 1 1 3 3 2 2 2 1 1 2
1202131323302231210323132
1 0 1 0 1 3 0 2 1 2 0 0 0 0 1 2 1 3 2 1 3 0 1 1 2
3313210033012101030031310
2 3 1 0 0 3 3 3 1 1 0 0 3 1 3 0 3 2 2 3 1 1 3 3 0
1 3 2 1 2 0 0 0 2 1 0 1 1 1 2 2 1 0 2 3 1 3 2 1 0
2  0  2  0  3  1  3  2  1  3  2  2  2  2  1  3  0  1  2  2  2  2  1  3  2
0 0 1 0 0 1 0 1 1 0 1 1 1 1 0 1 0 0 1 0 0 1 1 1 0
