233003213132201202230010332030
312111000311132310312000121232
233030232320200012013132110032
1 0 1 3 2 0 0 0 2 2 2 2 3 2 3 3 0 2 3 0 3 2 2 0 3 2 1 0 3 2
330221300213300310133223132322
0 2 0 0 2 0 2 1 0 3 2 0 2 1 3 2 0 3 0 3 1 3 2 1 3 1 0 1 2 2
3  0  3  2  2  3  2  1  0  3  0  3  1  2  0  1  3  0  1  2  0  3  3  2  0  0  2  3  3  0
332023230030030112310002133212
3  1  1  2  1  3  0  1  0  3  3  1  0  3  2  3  2  1  1  0  3  0  2  0  1  0  3  2  1  0
3 2 0 1 3 3 3 2 1 1 0 2 2 2 0 0 2 3 1 3 1 3 0 3 0 2 2 1 1 0
010103221223331223333030321332
231122103000102232322032323002
0  1  3  0  2  2  2  3  2  0  1  1  2  2  3  2  3  1  3  2  3  0  3  2  3  0  0  3  3  2
0 2 2 0 0 0 1 1 2 0 3 0 3 3 1 2 1 1 1 2 0 1 1 0 3 1 3 1 1 2
3  2  1  0  3  0  1  0  0  1  1  2  3  1  1  0  3  1  3  3  2  3  1  0  0  3  0  3  3  2
3 2 0 3 0 1 2 2 1 1 2 2 3 3 0 3 1 2 2 1 1 0 1 0 0 2 1 1 3 2
3 1 3 2 3 2 1 1 0 1 3 1 1 1 3 3 0 2 2 1 2 0 3 3 0 2 2 2 1 0
3  2  2  3  2  1  0  2  2  2  2  3  0  3  2  1  2  1  3  1  3  1  1  3  2  3  0  0  3  0
0  1  1  1  0  0  1  1  0  1  0  0  1  0  0  1  1  1  1  1  0  0  1  0  0  0  0  1  0  0
