1  1  3  1  1  0  2  3  2  0  1  0
2 3 2 2 1 0 3 1 3 1 2 2
023212133010
133010212102
1 3 2 3 0 1 1 2 0 3 1 2
3  2  3  0  2  1  0  3  3  3  0  2
1  0  1  2  2  3  0  2  3  2  1  2
2 2 1 2 0 3 1 3 1 2 0 2
1  0  3  2  1  0  1  3  2  3  2  0
111113220222
012321120100
312000013212
3  2  1  0  2  3  3  0  1  0  2  0
320101320102
2 2 2 2 1 2 2 1 3 2 1 2
133322003312
2 3 3 1 0 2 3 3 2 2 3 2
0 0 0 3 3 1 3 2 2 3 0 0
001200210200
010010000110
