0  2  3  2  0  0  1  0  1  0  0  1  3  2  0  0  1  3  1  0  3  0  0  0  1  3  2  3  2
03133000332322113211222120102
23313010113211032331200010032
3 0 0 1 0 1 2 1 3 1 0 3 1 2 1 0 0 1 0 3 0 1 3 3 3 0 2 1 2
0 1 3 3 1 3 2 2 3 3 2 1 1 1 1 2 3 1 2 2 0 0 2 3 0 0 1 2 2
11001120000030111321032213300
2 1 3 3 1 2 1 1 0 0 1 0 3 3 0 0 2 1 0 1 1 1 0 2 2 3 0 1 2
1 3 2 0 1 2 2 1 1 0 3 2 1 2 1 0 1 0 2 0 2 0 0 1 0 1 0 0 0
32212313223123103022133103310
3 3 0 0 2 1 2 1 3 2 0 2 0 1 3 2 1 3 1 0 2 0 2 2 0 2 3 2 2
11012311221302320003010201210
10111100000010100110101010110
