10111300010
32212212030
00103210200
1 3 2 2 0 0 0 0 3 0 2
02003122022
2  2  1  2  3  3  0  2  3  2  0
2 3 3 3 2 0 1 2 0 0 2
20203303312
1  1  0  2  0  1  2  1  3  3  0
0  2  1  2  1  0  0  2  2  0  2
2  3  1  1  3  3  0  3  3  3  2
01300020312
0  1  0  2  0  0  2  3  0  1  0
3  3  1  0  3  2  0  1  1  0  2
30302300032
1 1 1 1 2 1 2 2 2 2 2
2  0  3  2  0  1  2  0  3  1  2
1  0  3  3  2  2  3  1  3  2  2
00110320002
2  1  1  0  3  2  0  0  1  0  0
1  1  1  2  2  1  3  0  2  0  2
1 3 1 3 0 0 3 3 0 0 2
1 0 0 2 3 1 3 2 2 3 2
1 3 2 0 1 0 1 0 1 0 2
0 0 2 3 1 0 1 3 2 2 0
10001101000
