21231331210210
1  0  1  1  1  1  0  0  1  0  2  2  0  2
0  3  0  2  0  1  2  1  2  2  0  0  3  2
1  3  0  0  3  0  3  1  1  0  1  1  3  0
1  3  2  1  1  0  2  0  0  2  2  0  3  2
30010300132130
22301113000322
3  2  0  0  1  1  2  2  0  3  1  0  2  0
2  1  1  0  0  0  0  0  0  0  1  2  1  0
10020232203100
01130020223100
0  2  2  0  3  1  2  1  3  2  2  1  2  2
0  1  0  1  2  3  1  1  2  1  1  0  1  2
2 0 2 3 0 3 0 0 3 1 1 3 0 2
10021113022200
20011000113120
0  2  0  1  2  0  1  3  0  3  2  1  3  0
02312001101332
3 1 1 2 2 0 3 0 1 3 0 0 2 2
2  2  3  3  1  2  0  2  3  3  3  3  3  2
31302323010112
3 1 1 0 0 1 1 0 0 3 0 3 0 2
11101011111000
