1  2  3  3  2  3  0  3  1  1  0  0  3  0  3  1  2  2
023320133322222310
2 1 2 2 3 2 2 1 0 1 3 3 2 3 3 1 0 2
3  3  0  1  3  2  0  1  1  2  2  2  2  1  2  3  0  0
311320023032303100
0 3 0 2 1 2 1 3 0 2 1 0 0 1 2 1 2 0
1  1  0  2  3  0  0  3  0  2  1  2  2  3  2  1  2  2
3 0 2 1 0 1 3 1 2 2 0 2 3 1 0 3 3 2
302320212221300032
130313313033202210
0  1  1  1  1  0  3  1  3  3  1  2  1  0  2  1  1  2
0 3 2 3 0 2 1 3 2 2 0 1 0 1 0 0 2 2
3  3  0  2  1  3  3  3  3  3  2  3  0  3  2  2  1  2
2 1 2 2 1 0 2 1 3 2 1 2 2 1 0 0 1 0
0  3  3  3  3  1  3  0  1  3  3  3  0  3  1  1  2  0
333101121112300002
0  3  1  1  1  3  3  3  0  0  0  3  1  1  0  1  0  0
013022200210300322
121102111232211202
1  3  3  1  0  3  1  0  0  0  0  3  0  3  2  0  0  2
000101111000010100
