2  2  0  3  3  1  0  2  2  3  2  3  2  2  1  3  3  0  0  2  1  2  1  3  3  0  2  0  1  0  0  2  0  1  1  0  3  2  0
3 0 2 2 3 0 1 0 2 2 3 1 1 1 2 2 0 2 3 1 3 3 2 1 2 0 2 0 2 2 3 1 3 1 2 3 2 1 2
1 2 3 3 2 1 1 0 3 1 2 3 2 0 2 3 3 1 3 3 1 3 1 2 2 0 1 1 0 0 0 2 3 2 1 3 0 2 2
223311132110210122213211030211313333322
3 3 0 0 0 1 0 0 2 3 1 1 2 3 3 2 2 3 0 2 1 2 2 1 2 1 3 0 2 2 0 1 2 3 2 1 1 1 2
033231221200230131113102322020231211132
300002011310332123231323302223222323110
331220212312222002030132021021323003022
0 3 2 3 0 3 2 2 2 3 0 1 1 0 1 2 3 3 2 3 3 1 1 2 3 2 1 2 3 2 2 2 3 3 1 3 2 3 0
2 3 2 0 2 0 2 2 1 1 0 3 0 1 3 2 2 0 0 3 2 1 0 1 2 1 2 1 1 3 1 1 1 0 2 0 1 1 0
1  3  3  3  3  0  1  2  1  1  3  3  0  1  1  3  2  3  2  1  3  3  1  0  1  2  2  2  2  0  3  0  3  1  3  3  2  0  0
0  0  2  2  1  0  3  1  0  0  0  0  2  2  3  1  1  3  1  0  0  2  2  3  0  0  2  0  1  1  2  0  3  3  2  3  0  3  2
0 3 2 3 1 3 3 3 0 1 3 3 3 2 1 1 2 2 0 2 0 0 2 0 2 1 3 0 3 3 1 2 2 1 2 0 0 2 2
2  2  2  1  1  1  2  0  2  2  2  3  0  3  1  2  3  2  1  3  0  2  1  0  1  3  2  1  1  1  0  2  0  2  1  0  0  0  0
2 2 3 1 2 0 2 0 3 2 0 2 3 1 0 2 3 3 0 3 0 2 3 1 0 0 1 1 2 3 3 1 0 0 0 3 1 3 0
113310211101021103331100121010221133300
0  2  0  0  0  1  2  2  0  0  3  3  3  2  1  3  1  0  2  0  0  0  1  2  0  2  2  1  3  0  1  2  2  2  0  1  3  2  0
013030203032201303302212332131031013030
1 0 0 0 0 0 0 0 1 0 0 1 1 0 0 0 0 1 1 0 1 0 1 0 1 0 0 0 1 1 0 1 1 1 1 0 1 1 0
