2  1  2  0  3  0  2  0  1  1  3  3  2  1  1  3  0
12220100102231122
1  1  0  2  0  3  2  1  3  3  1  0  2  3  0  1  0
3 2 3 0 0 3 0 3 0 0 2 1 0 2 3 0 2
1 0 1 1 3 3 1 3 1 1 0 1 3 3 3 3 2
11113133230001020
0 3 2 0 1 1 0 0 0 1 3 0 2 1 2 3 0
11103101122223122
10220002233022222
01032333301333132
1  0  2  1  1  1  0  2  1  1  2  1  2  0  0  1  2
2  1  3  0  2  1  1  0  3  2  1  0  1  3  0  1  0
3 0 2 1 2 1 1 3 1 1 2 1 0 2 3 1 0
0  2  2  2  2  1  0  1  2  1  0  2  0  0  2  0  0
20112010331133300
1  3  3  3  1  1  0  0  2  1  1  3  2  3  2  0  0
3 3 3 0 3 0 2 1 2 2 0 3 2 0 2 0 2
0  0  2  2  2  2  2  3  1  0  3  2  1  0  2  3  0
0 3 2 1 3 1 2 3 2 2 1 3 3 2 3 2 2
2 0 0 1 0 0 1 1 3 2 3 3 0 1 2 1 0
1  1  0  0  2  0  3  2  0  3  2  1  2  0  3  0  2
3 3 3 1 2 2 0 3 1 2 1 0 1 2 1 1 2
1  1  0  0  1  1  0  0  0  1  1  0  0  1  1  1  0
