0 0 2 0 0 1 2 2 1 3 1 2 3 0 2 1 2 2 2 3 2 0 3 2 0 2 0 2 2 1 3 2 1 1 1 1 3 1 0
1 1 2 3 2 1 0 3 3 2 1 2 1 2 3 0 3 3 1 2 3 2 3 0 0 1 2 0 3 0 3 1 3 0 2 1 1 0 2
001232121333111203310312110322022033030
2  2  1  0  1  1  1  0  2  2  0  1  1  1  2  0  2  2  0  3  2  3  3  3  0  0  2  0  0  0  3  3  3  3  0  2  2  3  0
0  2  2  0  2  2  0  1  1  3  0  2  1  3  2  0  1  3  0  3  3  0  1  2  1  1  2  1  3  2  3  2  3  0  2  3  3  1  0
1 3 3 1 1 3 0 2 1 3 3 2 0 2 2 3 2 0 1 1 2 0 3 3 0 3 1 1 3 1 2 0 1 0 3 0 2 0 0
0  0  3  0  0  3  0  1  0  1  3  1  2  1  2  2  3  1  3  0  3  0  2  0  0  1  0  2  0  2  3  3  0  3  2  3  1  3  2
1 1 1 2 3 0 0 1 3 3 1 2 3 3 1 1 3 0 1 0 2 0 0 3 0 0 3 1 2 3 0 0 1 3 0 1 2 0 0
0 2 0 1 3 0 2 1 0 0 2 3 3 2 3 1 3 1 0 0 2 1 1 2 0 1 3 3 1 1 0 2 1 0 2 0 0 0 0
0  0  0  2  3  3  2  2  3  2  2  2  3  0  3  0  3  1  0  1  0  1  2  3  1  0  3  1  3  0  1  1  2  1  1  3  1  2  2
3  1  2  3  3  0  0  1  3  0  1  0  1  1  3  2  1  1  2  0  3  1  2  1  1  0  0  0  0  0  1  2  0  3  0  0  2  3  0
002323323032101310022221323011212302210
212210002303003203130201131021133010322
2 2 2 1 3 2 1 2 1 3 0 2 2 1 0 2 1 1 1 3 0 3 0 2 2 3 2 0 3 3 1 2 3 3 3 3 1 0 2
0 1 0 0 0 1 0 0 1 1 0 1 1 0 1 0 1 1 0 0 1 0 1 0 0 1 0 0 0 1 0 0 0 1 1 1 0 1 0
