1 2 3 2 2 1 2 1 3 2 0 2 1 1 2 2 3 1 2 0 0 3 2 3 2 0 2 1 1 0 0
2311011023122130311000110022000
2211221232220122231202112301300
3 3 0 3 3 0 3 0 0 3 1 2 1 3 0 0 0 3 1 0 3 0 3 2 1 3 0 2 3 1 0
0321211212323032333312101010110
2 3 0 3 0 2 1 2 1 0 3 3 1 1 0 3 1 0 2 1 0 3 1 1 2 2 2 2 0 0 2
3322121313322103211311110221112
2030322201323003100023302000110
1121232122222303203311103111302
0113332002121310131002032130312
0 2 0 3 2 1 2 2 0 1 3 2 3 1 3 0 1 3 2 2 3 1 2 2 0 0 0 2 0 2 0
0 1 3 3 1 2 2 1 1 2 1 2 1 0 3 0 0 3 2 3 3 2 0 2 0 1 3 0 3 1 0
2  3  1  0  0  3  1  0  2  0  1  3  2  3  2  2  1  3  3  1  2  3  3  1  0  0  2  1  3  3  2
0  2  0  0  2  1  1  3  2  3  0  1  3  1  1  1  3  1  2  0  0  1  2  2  3  1  2  3  3  1  2
2130002320030212113132211230212
2  0  0  0  0  1  3  3  0  2  3  0  0  3  2  1  2  3  2  2  3  3  3  2  0  3  0  2  0  3  0
0 3 1 3 0 1 1 1 2 3 2 3 0 0 2 1 1 3 2 3 0 0 3 3 1 0 3 0 2 0 0
3303003312032213112221013022102
2 1 0 1 2 1 3 0 1 1 3 3 0 0 3 0 2 3 3 0 0 2 2 1 2 1 1 0 0 3 2
1 3 1 3 2 0 0 0 1 1 2 0 1 2 1 1 3 1 1 1 0 3 2 0 0 3 0 0 1 3 0
0 1 0 0 3 3 2 0 2 1 0 0 0 3 3 3 3 0 3 1 1 1 2 3 3 1 0 1 0 1 0
1 3 1 0 2 1 0 2 0 3 0 3 3 3 1 1 2 2 0 1 3 0 3 1 2 2 2 1 0 2 2
1110011110000000011010000110100
