1 2 2 3 0 0 2 2 3 0 0 2 3 0 2 3 1 3 0 1 0
330321213113312102210
2 2 0 1 3 0 1 2 3 1 2 1 0 0 0 1 3 1 3 1 2
012232322100020320210
321211012033212002310
3 2 3 3 0 1 3 1 2 2 3 3 3 0 0 1 0 1 1 1 0
3 2 0 1 1 2 2 3 0 3 1 0 3 3 1 1 1 3 0 3 2
1 3 3 3 0 1 2 2 0 2 3 2 1 1 1 1 2 1 0 2 0
3  0  1  0  2  0  1  1  2  1  0  3  0  1  3  2  3  1  1  1  0
111011211012232311002
3 3 3 0 3 2 1 3 0 1 2 2 1 0 3 3 1 0 0 0 2
0  2  0  3  2  3  1  1  3  2  1  0  1  2  2  2  1  1  2  2  0
132302200212203000320
2 1 1 1 3 3 3 0 1 3 1 2 3 0 3 3 3 3 0 1 0
1  2  0  0  0  0  2  0  1  1  2  3  2  2  2  0  2  1  1  2  0
302103020213220033312
1 0 2 3 3 1 1 2 3 0 1 1 2 2 2 1 0 2 1 1 2
2 0 2 1 3 1 3 1 3 1 1 0 2 3 0 1 1 2 2 0 2
3 1 0 2 0 0 2 1 0 1 0 0 1 3 0 1 2 3 1 0 2
212221213233130120200
3 2 1 3 1 3 1 0 0 2 1 0 1 0 0 3 2 2 1 3 2
0  0  0  1  1  0  1  0  0  0  1  0  0  1  0  1  1  0  0  0  0
