3  0  2  2  1  2  1  1  0  2  1  1  0  3  3  2  1  1  2  3  0  1  3  0  2  3  2  0  0  0  3  3  2  2  2  2  0  1  2
3 3 2 3 2 0 3 0 2 2 2 3 0 0 0 3 2 0 2 0 3 3 0 0 3 1 0 1 3 1 2 0 0 1 3 0 0 3 0
3  1  1  3  1  1  2  2  3  3  1  2  2  3  2  3  2  1  3  1  3  1  2  1  1  0  3  3  3  2  1  1  3  2  0  2  2  2  2
3  3  1  0  3  0  1  2  3  2  0  2  3  2  0  3  3  1  2  3  1  1  0  2  2  0  0  0  2  2  2  2  1  1  0  2  0  0  0
111100000030310023330120122030332331032
2  0  3  0  0  2  0  0  3  1  3  2  0  1  3  2  1  0  2  2  2  2  0  0  0  1  0  2  2  1  1  1  0  3  1  2  2  1  2
0 3 2 2 1 3 0 3 2 2 2 2 2 1 2 0 3 2 0 3 3 2 1 1 3 0 0 0 2 3 1 0 1 0 1 2 1 0 2
0 0 3 3 1 3 2 0 3 2 1 0 0 1 3 3 0 3 1 0 3 3 1 0 3 2 3 3 2 3 2 3 0 2 1 1 1 1 0
3 1 0 1 3 2 2 1 1 0 1 2 0 0 1 2 0 3 2 3 1 2 2 0 3 0 1 0 3 0 1 3 1 2 1 2 2 0 0
1  1  2  0  3  0  3  1  3  1  0  3  1  1  0  1  3  0  0  3  2  3  0  1  1  0  0  2  1  1  0  1  2  2  3  0  0  1  0
1  0  2  2  1  1  3  0  3  1  3  3  3  3  2  2  1  0  1  2  1  0  3  0  3  1  3  3  1  1  1  2  1  2  0  3  1  0  2
1 0 1 0 1 1 3 2 0 3 2 3 0 0 0 0 0 1 0 1 2 0 3 3 0 3 3 1 0 1 0 0 0 2 3 1 1 2 2
311211012011313223032303002202133131132
1 3 1 1 2 3 3 1 0 1 3 1 3 0 2 3 0 3 2 2 1 2 2 2 2 2 3 0 0 2 3 3 0 0 1 0 2 0 0
020310103310020020113231000301201100010
2 0 3 0 1 1 1 0 2 3 1 2 1 1 1 2 2 3 1 3 3 2 2 2 3 3 3 1 3 1 3 2 1 1 0 1 3 2 0
1 1 3 1 1 1 0 1 0 1 2 3 3 0 1 1 2 1 2 3 1 3 2 0 0 3 2 1 2 2 3 1 3 2 3 1 0 0 0
0  0  0  0  1  3  2  3  2  1  3  3  1  3  0  2  3  2  0  2  1  3  1  2  2  1  1  2  0  3  0  2  1  0  3  2  0  2  0
002333200321230120301302112322310223112
121323003200102303000202331001320212132
2 0 3 2 2 2 2 2 2 2 3 2 1 1 0 3 3 3 3 2 2 3 0 3 0 1 3 0 3 2 2 2 1 0 0 0 2 3 2
3 2 2 2 3 2 1 3 3 1 1 1 2 2 3 3 3 0 2 1 2 2 2 1 1 3 1 0 0 2 3 0 3 2 1 1 3 2 2
330023321313322022021023102032120031310
3  3  2  2  2  3  3  3  1  3  2  1  3  2  2  3  1  2  2  0  0  0  0  1  1  3  0  0  1  1  2  3  0  1  1  2  0  0  0
3  1  1  3  1  0  2  3  0  0  0  2  0  3  2  0  0  3  1  2  2  0  2  0  1  1  2  0  3  2  1  2  1  2  0  0  0  3  0
221113102102330213013323102212201131330
2 0 0 0 2 0 1 3 0 3 0 3 3 0 1 3 3 3 0 3 3 0 0 2 2 3 1 0 2 2 1 2 0 1 2 0 3 1 2
1 0 1 0 3 1 3 0 3 2 3 1 0 2 1 0 1 3 1 2 3 3 0 0 1 3 0 0 1 1 3 0 2 3 0 0 0 1 2
1  0  1  1  1  0  0  1  1  1  1  1  1  1  1  1  0  0  1  0  1  0  1  0  1  1  1  1  0  1  0  1  0  1  0  1  1  0  0
