1  3  2  2  3  0  3  1  2  1  0  2  1  2  1  2  0  1  0  1  1  1  1  0  0  1  0  0  0  0  0  1  3  3  0
01021110132002003103232130220301300
1  2  2  3  1  2  3  1  0  2  0  0  1  3  0  3  3  1  2  0  1  1  2  0  3  1  3  3  1  3  2  0  3  3  2
13320032012213102031322221013230032
3 2 3 2 0 2 3 2 3 2 2 0 1 0 2 0 1 1 0 2 1 0 0 0 1 0 3 3 3 1 0 2 2 1 2
0 2 1 2 0 3 0 2 0 2 0 3 0 1 2 3 2 3 1 0 3 0 3 0 2 0 3 0 0 2 2 2 2 2 0
0  0  3  0  0  2  1  3  1  0  3  1  2  3  2  3  2  0  3  0  2  0  3  0  3  2  1  0  2  3  3  0  0  2  0
13100000120322033320132030121001210
0 0 3 3 3 3 2 3 3 1 2 1 3 2 0 3 1 2 2 1 2 3 1 0 2 1 3 2 1 1 2 0 3 2 0
2  3  2  1  0  3  3  3  3  1  0  2  0  1  2  3  2  3  1  2  0  3  0  3  0  2  1  2  0  3  1  1  2  1  2
0 2 0 1 0 0 0 1 2 3 0 1 1 3 0 1 2 0 3 2 0 1 1 1 3 2 3 2 1 0 3 3 1 3 2
2  3  2  3  1  0  0  3  2  2  0  3  3  2  0  2  1  1  1  0  2  2  1  0  0  2  3  2  2  3  0  0  0  2  0
20011000303222013122321022122102330
2 0 1 0 0 1 2 2 2 3 0 3 0 3 2 2 0 0 3 3 0 2 2 1 0 2 3 1 0 3 3 3 2 0 0
2 2 2 1 1 3 3 2 0 2 0 3 3 1 1 2 3 0 3 0 0 2 2 3 2 0 0 1 1 2 3 1 0 3 2
2  0  3  2  1  0  1  1  1  2  2  2  3  2  3  3  2  3  1  1  2  0  1  3  2  1  0  3  1  0  2  1  2  0  2
3  3  2  1  1  2  0  0  3  3  1  2  1  2  0  0  0  0  3  1  3  3  1  2  0  0  1  3  1  2  1  0  3  1  2
00033232010022212313333312310310010
1  0  1  2  2  3  3  0  3  1  3  3  0  0  3  0  3  2  2  1  2  1  2  1  1  0  3  0  0  1  1  0  3  0  2
2  0  3  1  3  2  0  3  2  2  2  2  3  2  2  3  3  0  0  3  3  0  3  3  3  1  1  3  1  1  3  1  0  1  2
33303201301032211130312232112203322
3  0  3  2  2  2  2  1  2  3  0  1  2  2  1  1  3  0  1  2  2  3  1  0  0  2  0  0  3  3  3  0  2  3  2
1 1 2 0 2 0 2 1 1 2 0 0 0 3 1 2 3 0 1 2 3 1 2 0 3 3 0 2 0 3 1 1 0 3 2
20200221131130300310010221321333010
30211033032233023230033113133031210
01013023001110202022333122121203112
3 0 0 0 0 1 1 2 3 2 0 3 2 0 3 1 2 0 2 2 0 2 1 3 1 2 3 1 3 1 2 3 3 2 2
0  0  0  1  1  1  0  0  0  0  1  1  0  0  1  1  1  1  0  0  1  1  0  1  1  1  1  0  0  1  0  0  1  1  0
