1  3  2  3  3  0  3  1  1  1  1  3  1  0  2
103323011310232
1  0  0  1  1  3  1  3  2  0  0  1  0  1  0
3 1 3 1 2 1 3 2 0 1 1 0 3 1 2
221111231222010
313021231322210
0  1  1  0  3  1  3  3  2  2  0  2  3  1  2
2 2 1 0 3 2 2 1 0 1 1 2 3 0 2
2  0  2  3  0  3  1  2  1  1  0  1  1  2  2
003001302313220
2 3 2 3 3 0 0 0 3 2 0 3 1 1 2
012012013201330
223131320112010
0 2 2 2 1 2 2 0 2 2 2 3 0 1 0
210202012330022
202101333302222
303012121033000
001110001001110
