0112222011313203310202120310121021321230
0  3  2  1  2  0  1  1  0  2  3  2  0  1  1  2  1  1  2  1  2  2  0  0  2  3  2  1  3  0  0  0  1  1  3  1  3  3  2  2
0  1  1  1  3  2  0  3  3  3  2  0  1  2  2  2  0  3  3  1  0  2  3  2  2  0  3  2  3  1  3  1  3  2  3  2  3  0  0  2
1  3  0  2  3  3  3  2  0  0  3  1  2  0  2  0  3  3  0  1  1  1  0  0  1  0  0  3  1  1  1  2  1  1  0  0  0  0  0  2
2 1 1 2 0 2 2 1 3 3 3 1 3 0 0 2 0 3 2 1 1 0 3 0 2 2 1 2 0 1 0 1 0 1 1 3 1 1 1 2
0 3 1 0 3 1 2 3 1 1 1 0 3 0 1 1 3 1 3 3 1 2 3 3 1 0 0 1 0 1 3 1 2 1 2 2 3 2 1 0
3  0  3  1  3  0  1  2  2  2  3  1  2  1  0  1  0  0  3  3  0  0  1  3  3  3  3  2  1  2  0  3  1  3  3  1  0  3  0  2
2 3 1 2 3 3 0 2 2 0 0 1 1 2 2 2 1 1 0 1 2 3 1 3 1 3 1 1 0 3 2 2 3 2 2 0 2 0 3 0
3221113230003121321021130301230230333210
0  0  0  2  3  1  0  3  2  3  2  3  1  2  3  3  2  3  3  3  0  1  1  2  2  0  1  0  2  3  0  3  3  2  1  3  1  1  2  0
2  3  2  3  1  0  1  2  3  3  0  2  3  3  3  0  0  1  2  3  2  1  3  1  3  3  3  3  3  1  2  0  3  3  2  0  3  2  0  0
1 2 2 0 1 0 1 0 2 1 0 3 3 1 2 2 2 2 1 2 3 2 1 2 3 0 2 1 3 3 3 1 0 0 0 3 1 2 1 2
2 0 3 1 2 2 3 0 2 0 3 0 2 3 0 1 3 0 1 2 3 2 0 2 0 2 0 2 0 1 3 1 0 1 3 0 0 2 2 0
2  0  2  3  2  3  0  2  1  1  0  2  0  2  2  2  3  3  1  3  0  1  3  1  1  0  2  3  1  2  3  0  1  1  3  3  0  2  3  0
2 0 0 1 3 2 0 1 3 3 3 1 3 0 3 2 2 2 3 3 1 3 0 2 3 1 0 1 1 1 0 2 0 0 2 2 2 3 0 0
1  1  0  3  0  3  3  0  3  1  0  3  0  1  2  3  0  1  0  3  3  2  2  2  2  0  3  0  2  0  1  0  0  2  3  1  0  1  2  2
2  1  1  1  3  1  2  3  1  0  0  3  0  3  0  3  2  2  1  0  3  2  2  3  3  0  3  3  1  1  1  3  1  0  0  3  2  0  0  0
2302130001112322222131033130203132001112
1 1 0 3 0 3 2 0 3 0 1 2 3 3 0 2 1 1 1 2 0 0 2 3 3 2 2 2 3 3 0 3 2 1 0 1 3 2 0 0
0  3  0  0  3  2  2  2  2  2  1  0  2  1  1  3  0  2  2  2  1  2  1  3  0  2  2  1  2  2  1  0  2  3  1  0  1  2  1  2
3001013300002002332100311312111211111222
3  1  2  0  1  2  1  3  2  1  3  3  1  2  2  2  0  3  3  3  1  1  2  3  2  1  1  1  1  3  0  2  2  2  0  1  1  2  1  0
3232000121320323100001223203122020010202
3 2 3 1 0 1 0 0 1 2 3 1 0 1 2 3 3 1 3 1 0 0 1 3 3 1 3 3 2 2 0 2 1 3 2 3 3 2 1 2
0  3  0  2  2  1  0  0  0  3  3  2  0  1  2  0  1  1  0  3  0  1  1  1  1  0  2  0  0  0  3  3  0  1  2  0  1  3  3  2
1220030223213223310032112220133100303230
0133003020030223011203130122213310000120
1  1  3  3  3  3  0  1  2  1  0  3  3  0  1  3  1  0  0  0  2  1  0  3  1  0  1  1  1  2  2  1  1  1  3  1  0  3  3  0
0  1  3  2  0  3  3  3  1  0  2  0  2  2  0  3  2  2  0  2  0  3  3  1  3  1  1  3  0  2  3  1  3  3  1  3  0  0  0  2
0 1 0 1 1 1 0 0 1 1 1 1 0 0 0 0 0 0 1 0 1 1 1 1 0 0 0 0 0 1 1 0 0 1 0 0 1 0 0 0
