0 3 1 2 3 0 1 2 3 2 1 2 1 3 2 0 3 3 1 2 2
001332032120132322202
100131311001303312100
212132213013033102322
203200302121322201212
011220320131203311210
121130103113122310200
2  0  3  0  1  2  3  0  3  0  2  1  2  3  3  3  2  1  1  0  0
1 0 0 3 0 0 3 2 3 3 2 2 1 1 3 0 2 1 3 2 2
0 3 2 1 2 2 0 0 3 3 2 2 0 2 2 3 3 2 0 1 0
2 1 2 2 0 0 1 1 3 2 3 1 3 1 2 2 1 0 0 3 0
3  2  0  2  1  3  1  1  2  1  0  3  1  2  3  1  1  2  3  3  0
2 3 0 2 2 2 3 3 0 1 2 2 3 2 0 0 2 2 2 0 0
213322030131312322200
3  3  3  1  0  1  3  3  1  2  2  3  3  1  2  2  2  2  0  1  2
3  1  2  0  0  2  3  0  0  2  3  0  2  0  3  1  2  2  0  3  0
1  3  0  1  2  3  0  3  3  1  3  3  3  3  1  2  3  2  0  0  2
1  0  3  2  3  0  3  2  3  1  0  1  0  2  1  1  3  1  2  2  2
0 3 0 1 2 2 2 3 2 2 0 1 1 2 1 0 1 1 3 1 2
1  1  1  1  0  2  1  2  1  2  1  2  2  3  2  0  0  0  2  0  0
0 0 0 1 1 1 1 1 1 1 1 1 1 1 0 0 0 1 0 1 0
