2 3 2 1 2 0 3 3 2 2 1 0 3 1 0 3 0 1 3 1 0 0 0 3 0
2  2  2  3  1  2  3  2  1  2  0  3  1  1  2  1  3  3  0  1  3  2  1  0  2
2 1 0 3 2 0 3 0 0 2 3 0 3 3 2 1 2 1 2 2 1 0 2 1 2
0 3 2 2 0 1 1 2 3 3 3 0 1 0 2 1 3 2 0 2 2 2 3 1 0
2102113320212033221230300
1  1  0  1  0  0  3  2  2  1  2  0  1  1  0  0  2  2  2  0  3  0  2  2  0
2 1 0 3 1 0 2 0 3 0 3 1 2 0 2 2 1 0 2 1 3 3 2 0 0
0211121023322320003320210
2100300003330210312220202
2 1 0 1 1 0 0 3 2 1 2 1 2 1 2 3 3 0 1 3 3 1 2 2 2
2 0 1 0 2 0 3 0 3 2 3 3 1 1 1 1 1 1 2 1 2 0 3 1 0
3  0  1  0  2  2  2  1  2  2  0  0  1  2  2  1  2  2  1  0  2  2  3  2  2
3 3 1 3 0 0 3 0 3 1 1 3 3 3 1 2 2 0 1 3 3 3 2 1 0
3  0  1  3  2  0  1  2  0  1  1  1  0  3  0  0  0  1  0  0  1  0  0  3  2
3 0 1 2 3 2 0 2 2 2 1 2 3 2 1 2 0 0 3 0 2 3 0 1 2
0 1 0 0 1 0 1 1 1 1 1 0 1 1 1 1 1 0 0 1 0 0 1 1 0
