3 0 2 3 3 3 1 3 2 2 0 3 0 1 1 1 1 3 0 0 0 2 1 1 0 3 0 0 0 3 0 2 3 2 0 2 1 1 0 2 0
32000103332203100003133021020033031011320
2 1 3 2 1 0 0 3 0 3 0 1 3 1 2 1 2 2 2 1 0 2 3 0 2 0 1 3 2 0 0 3 0 3 3 0 1 2 0 0 0
0  3  1  3  2  2  3  3  3  3  3  3  3  1  3  3  2  0  1  2  0  2  0  1  1  2  1  3  2  2  2  0  0  3  2  1  1  0  2  0  0
12133030210112313312202101332212212011310
1  0  1  1  3  2  0  3  0  1  2  2  3  1  2  0  1  2  2  0  2  0  1  1  0  0  3  2  2  0  0  0  0  0  1  3  1  1  0  3  0
1 1 2 2 3 0 3 3 3 3 0 2 2 2 0 3 2 3 2 0 0 1 2 0 0 2 0 0 2 2 2 3 0 0 0 3 0 0 0 3 2
0  2  3  2  1  3  2  1  3  1  0  1  3  0  2  2  3  1  2  2  0  0  2  2  0  1  0  1  1  0  0  2  3  2  2  1  3  1  3  2  2
02323003230213010233011321332203130000322
21002200332013201301301230102121112230032
2  0  0  1  1  0  0  3  2  0  1  2  2  1  2  2  0  2  3  2  1  0  3  2  1  0  1  3  2  0  2  3  2  0  3  0  2  2  2  1  2
2  3  1  1  3  0  2  3  3  2  0  3  3  0  3  2  3  1  1  2  1  1  3  0  0  2  3  1  2  0  0  0  2  3  3  0  3  2  1  2  0
2 3 3 0 3 3 2 2 3 2 1 1 0 1 2 3 3 2 0 2 2 2 2 3 1 1 1 3 2 0 1 1 3 2 0 1 2 2 3 1 0
0 0 3 2 1 1 2 2 3 1 1 3 0 1 3 3 1 1 1 3 3 2 0 3 3 3 0 1 0 3 1 2 2 1 0 0 0 3 2 2 2
2 3 2 0 2 1 1 1 1 0 1 2 3 3 3 1 1 3 2 3 3 3 1 2 1 0 0 0 3 2 3 2 3 1 0 3 2 3 3 3 2
3  1  1  3  3  1  1  2  2  1  0  3  0  3  3  1  1  0  1  3  2  0  0  0  0  1  0  0  1  0  2  1  0  0  0  1  1  2  3  2  0
0  1  2  3  0  2  3  3  3  1  0  1  2  0  2  0  1  1  2  1  1  0  0  0  0  3  0  3  1  3  3  0  1  2  0  3  3  2  0  0  2
2  3  3  0  1  2  1  0  0  2  3  0  2  3  1  2  0  2  2  3  0  1  0  3  0  2  2  3  2  3  0  2  2  0  0  0  0  3  0  2  2
3 3 1 1 3 0 2 0 1 2 3 0 3 3 1 2 0 2 2 1 0 1 3 3 3 0 1 3 1 2 1 2 3 3 2 2 3 2 1 3 2
2  3  0  1  3  2  2  0  1  1  2  1  1  0  1  2  3  3  2  3  3  1  2  3  2  3  2  0  3  1  3  0  0  0  0  2  2  0  3  2  2
10230113011130133001200001212022022200332
10010022131200213332133232003320311123212
1 1 2 1 0 1 3 2 3 0 0 2 0 1 2 3 1 1 3 2 0 2 0 0 2 0 2 3 0 1 0 0 0 2 2 2 0 1 1 2 0
1  0  0  2  2  2  0  1  3  0  2  1  0  2  0  2  0  3  3  0  2  3  0  0  1  3  3  0  0  2  2  2  3  3  0  3  3  3  2  1  2
3 1 3 2 3 0 1 0 3 2 2 2 1 0 1 0 1 1 1 3 1 3 3 0 0 3 2 3 0 3 2 2 3 2 2 2 1 0 0 3 2
2 3 3 3 2 3 1 1 1 1 1 1 0 2 1 0 0 2 0 0 0 3 0 0 3 2 1 1 2 2 0 0 1 1 3 0 1 0 2 2 0
3 1 1 1 3 2 3 1 0 1 1 3 0 1 1 0 1 2 1 1 0 3 3 0 0 3 3 1 2 2 1 2 3 2 3 0 1 0 2 3 2
1  1  3  2  0  0  1  3  2  2  3  1  0  0  2  0  2  0  0  0  0  0  3  2  0  2  0  2  1  3  1  2  0  0  0  3  0  3  1  0  2
0  1  0  1  0  1  1  1  0  0  0  0  1  1  0  1  1  0  0  0  1  0  1  0  1  0  1  0  0  0  0  0  0  0  0  0  1  1  1  0  0
