1 1 1 1 3 3 1 2 0 2 2 1 1 0 0
2 3 3 3 2 1 1 3 1 1 0 3 2 2 0
302020103332212
3  3  2  2  2  1  1  2  2  1  2  2  1  1  0
321301131110012
0 3 0 3 3 2 0 3 3 3 1 0 0 0 0
333303333202130
3  0  1  2  1  2  0  1  2  0  0  1  0  0  0
3  2  0  1  3  0  2  1  3  0  1  2  1  2  2
201020020000030
3 0 3 2 1 3 1 3 1 2 2 0 0 0 0
211101231031200
122231201302132
0 0 3 2 3 1 2 0 1 0 1 2 1 3 2
3 2 0 3 3 1 1 3 2 2 1 0 1 0 0
0 3 3 0 3 0 3 3 1 1 0 0 3 1 2
000012132321012
3  2  1  1  2  2  0  2  3  3  3  3  0  0  0
022212100332302
302200310210220
223301231003302
2 0 0 0 1 2 0 2 3 3 2 3 3 2 2
1  3  2  2  1  3  0  2  1  1  2  3  1  3  2
3  2  2  1  3  0  0  0  2  2  3  2  3  1  0
3  3  3  3  0  3  0  1  2  1  1  0  3  0  2
1 3 0 0 1 0 2 0 1 3 0 1 3 2 2
0  2  2  1  2  2  1  0  3  1  2  2  2  2  2
0  1  0  0  1  0  1  0  1  1  0  0  0  0  0
