2 3 2 2 3 2 3 1 2 0 0 3 2 3 1 2 3 0 3 0 1 2 3 3 0 3 0 1 1 0 3 0 2 2 1 3 3 0
2 0 1 2 0 2 3 0 1 1 1 1 0 2 0 2 3 0 2 2 0 1 1 0 0 3 1 2 2 3 1 0 0 3 3 0 2 2
0 3 1 3 2 1 2 2 1 2 1 2 2 1 0 2 3 3 3 1 1 1 3 3 3 2 2 1 2 0 2 1 3 0 0 1 0 0
2  1  3  1  3  3  0  0  3  0  3  1  2  0  1  1  1  3  2  0  3  0  1  2  1  2  1  2  1  3  1  2  3  3  3  1  2  2
22233233122222310221100323311011201132
2 2 3 0 1 2 1 2 2 2 0 3 1 1 0 2 3 0 2 1 2 1 1 0 1 1 0 1 2 0 0 2 3 0 0 2 2 2
12212031203322102302200021032023312322
10001331302110022312313120203111022130
12301233200210001232103032210122210102
0  3  3  0  1  3  2  1  1  0  3  1  2  1  1  3  1  2  1  0  3  3  3  3  1  2  2  3  3  0  3  0  0  3  0  0  1  2
3  2  0  3  0  1  0  0  3  3  1  2  0  3  3  0  3  0  2  0  2  3  3  2  0  1  2  3  0  1  2  3  3  0  1  1  1  0
02231202222103133103232333103233221032
32331201311330320002231222121300330302
0  3  2  1  3  1  3  3  3  3  0  2  3  3  1  3  1  3  0  2  1  3  3  2  1  1  0  2  3  0  3  3  1  0  1  3  2  0
02020231023010323301123202223301232302
1  1  2  0  2  2  2  1  0  0  0  3  3  0  3  1  0  0  2  3  0  2  2  2  1  3  1  0  2  3  2  0  2  3  1  3  3  0
2 0 1 3 3 3 3 3 0 3 0 1 1 2 2 1 3 1 3 1 0 1 3 2 0 1 3 2 2 3 0 3 1 1 2 2 1 2
3 3 3 0 1 0 0 3 3 1 0 0 1 0 2 1 0 3 2 1 0 2 0 2 0 1 1 3 3 1 3 3 1 2 2 2 0 2
33110012001000213022232202233320100022
10101033111100222010321223030301213232
12110103010300120223313231131110132002
3  1  3  3  1  1  3  1  0  3  2  0  1  0  1  0  1  0  3  3  3  2  1  2  0  2  3  3  1  1  1  3  1  2  3  2  0  2
31020231323022022110023002222013202102
2  3  3  2  1  0  1  3  1  2  2  3  3  2  3  2  1  1  1  2  3  2  3  3  1  1  0  1  2  1  0  0  1  0  1  2  3  0
1  1  0  0  1  1  1  0  1  0  0  0  1  1  0  1  0  0  0  1  1  0  0  0  1  1  0  1  1  1  1  0  1  1  0  0  0  0
