1  3  2  2  0  3  1  3  1  1  2  0  3  1  0  1  1  3  3  0  1  2  2  0  1  2  2  3  1  2  2
1022233102222031022332203211210
0212121210011233110223221001202
1  0  0  1  2  1  0  3  3  1  1  2  2  0  3  2  0  1  2  3  3  3  1  3  1  2  1  2  1  3  2
0031132031333231200233230033210
1 3 2 1 0 3 1 3 0 1 2 2 3 2 1 0 3 3 3 3 3 0 1 1 1 0 0 3 0 3 0
2  1  1  0  1  3  3  3  0  0  1  1  3  1  2  3  2  3  0  0  0  3  2  2  2  1  3  2  3  1  2
1 2 2 2 1 3 1 1 2 0 2 0 2 1 2 3 0 3 2 1 0 1 3 0 2 0 0 1 3 3 0
2230331321032013102132013002210
0123023201211121231031210331100
1  0  1  0  0  0  1  3  0  0  2  3  0  3  2  2  0  2  3  1  1  3  2  0  0  3  2  2  0  3  0
0110302313213013220223121100130
2202221031033203302211311032332
3103332332310101223320323101120
2201202201321331331100133223200
3301012110110000333112221220322
3 3 3 3 3 1 3 2 3 2 2 3 1 1 2 3 3 1 1 3 1 3 1 3 3 2 3 2 3 0 2
0  1  0  3  1  3  3  1  2  3  2  1  0  3  3  3  1  0  3  1  1  1  1  1  2  3  2  1  1  0  0
2121222112010332120322121031032
2 1 2 1 0 0 1 1 2 2 2 0 3 1 1 3 1 1 2 0 2 2 3 0 3 0 1 2 1 2 0
0  3  1  2  3  1  1  3  1  0  3  2  1  1  0  0  0  2  2  1  0  2  1  1  0  3  3  1  2  2  0
2 1 3 3 2 3 2 0 0 1 1 1 1 0 2 0 1 0 1 3 0 2 0 0 0 2 2 0 2 0 0
1022202302131310310320330001220
0  2  3  0  1  2  1  3  0  1  2  3  2  1  0  2  0  2  0  1  2  0  3  3  3  2  2  0  3  1  0
2  1  3  3  2  0  0  3  1  3  1  1  0  3  0  0  1  1  1  2  1  3  3  3  2  2  1  2  0  3  0
0  3  1  3  2  2  0  2  3  1  1  3  1  0  3  3  2  1  2  3  1  2  2  3  2  0  2  2  0  2  0
3322012100233222002230132133230
2 3 3 0 3 2 0 3 3 1 2 2 2 0 3 0 3 0 0 2 3 1 1 2 0 0 3 0 1 1 0
3 2 2 1 0 3 2 0 0 2 2 3 0 1 1 3 2 1 1 0 2 2 0 1 0 0 3 2 2 1 0
3  2  1  0  3  2  0  2  3  2  2  1  3  0  3  1  3  2  1  0  2  3  1  2  2  0  3  3  2  3  2
1  1  0  1  0  1  1  0  1  0  0  1  1  1  0  0  0  1  0  0  0  0  1  1  1  0  0  0  1  0  0
