020122210130
0 0 0 1 0 0 0 3 1 2 2 0
322020330310
1 0 0 3 3 1 0 0 1 1 2 0
022221202312
303313221212
3  0  2  0  1  1  3  0  2  3  1  2
303131130222
2  2  1  2  2  2  0  2  3  1  2  0
231303102002
0  3  1  2  1  3  0  1  0  3  3  0
303320221212
1 0 2 1 1 3 2 3 2 3 2 2
213223031030
1  3  1  3  1  1  0  2  2  1  1  2
2  0  3  2  0  3  0  0  1  3  1  2
002213311000
2  3  1  1  2  0  0  3  0  1  1  0
1  3  3  1  2  3  1  3  3  3  0  2
220220013130
1  1  0  0  2  2  0  3  3  2  3  0
3  0  2  0  0  3  2  1  2  1  3  2
3  0  2  2  1  2  3  0  2  1  0  2
1  3  0  1  0  1  0  3  1  1  1  2
2  0  2  0  2  1  2  1  3  2  1  2
0  2  2  1  1  0  0  2  2  3  2  2
3 0 1 0 2 1 0 1 2 2 3 0
3 0 0 3 3 1 1 2 1 0 1 0
101110101100
