00031222012101320232102231200032001230020
01222331122001000320202032131113103013030
1  1  0  1  1  1  2  2  3  1  2  2  1  3  0  3  1  1  1  0  1  1  3  0  3  3  2  2  0  1  2  3  3  3  1  2  1  0  2  2  2
2 2 2 3 0 3 1 1 0 0 2 1 2 3 3 3 0 2 3 0 3 3 1 1 1 0 0 3 0 3 3 3 1 0 1 0 1 1 0 3 0
0  3  3  0  3  2  1  1  1  0  0  3  2  1  2  3  2  3  3  1  0  3  3  3  1  1  1  1  3  2  2  1  0  3  0  1  2  0  2  2  2
12132220201113103212113033331222013013320
33001203101320230332100220101101102010300
20121003031233203333011020011022011310102
13222230301123111112013333300223012003112
3  3  3  3  3  3  1  0  3  1  1  3  0  1  3  0  1  0  0  3  0  1  0  3  2  1  3  2  2  2  3  0  1  2  1  3  2  0  1  1  2
23322220100020032100301231321102113001312
13221001221110220332210122310320021300230
0  0  2  3  2  0  0  2  2  2  3  2  0  2  2  1  2  2  0  1  2  3  1  3  0  3  3  1  2  3  3  0  2  0  2  2  2  3  1  2  0
01323322011331123331210013300330313112200
2  2  3  3  2  3  0  3  3  2  3  0  0  1  0  3  1  2  1  3  2  0  3  1  2  2  1  1  1  1  1  0  3  1  1  3  0  1  3  0  2
0  3  1  1  1  2  3  0  1  0  0  3  0  0  0  2  1  1  1  1  0  3  0  1  0  3  1  0  3  3  0  2  0  0  0  0  0  2  1  1  2
23221221130030300120023202320323131332012
0  3  3  3  0  2  1  3  1  0  3  3  3  2  2  0  1  2  3  3  2  1  3  2  3  0  1  2  3  2  0  3  2  3  2  2  2  0  0  3  0
0  1  3  1  1  1  3  1  3  1  1  3  1  3  3  0  0  1  1  3  3  2  3  0  2  2  0  3  1  3  0  3  0  0  0  1  2  0  0  2  0
3 1 3 0 3 0 3 0 2 1 3 1 3 3 2 2 3 2 2 2 3 3 1 3 2 3 3 3 2 3 3 3 0 0 2 1 0 3 0 1 0
13131202313313131220131301100031303022002
0  2  3  3  3  1  1  1  1  3  1  2  2  1  1  0  3  3  2  2  1  1  2  1  1  2  3  0  0  1  3  2  2  1  1  0  2  1  1  2  0
1 1 1 2 0 3 1 3 0 0 2 0 0 1 0 2 3 3 2 0 3 3 0 2 1 3 3 1 1 3 3 2 0 0 2 1 1 0 3 1 0
2 1 3 2 3 0 2 3 1 1 3 3 1 3 2 1 0 1 0 0 1 3 3 1 1 2 3 0 1 2 2 1 0 1 1 1 0 3 0 1 0
20230020023301012020011130201020233322300
0  3  2  3  1  3  2  3  0  0  3  2  1  2  0  1  1  3  0  1  3  3  1  0  3  0  3  0  0  0  1  3  0  2  0  0  3  2  3  2  2
1 2 3 1 0 1 3 1 0 0 2 0 3 3 1 1 1 3 2 0 1 1 0 2 2 0 0 3 0 3 3 0 2 3 0 0 0 2 2 1 2
1  2  0  0  1  0  2  2  1  2  2  0  2  1  1  0  2  3  0  0  1  3  1  2  3  3  0  2  3  2  1  3  2  0  2  2  0  2  2  3  2
11100211302120321202111032122003331013120
1 0 0 1 0 1 0 0 0 0 0 0 1 0 0 0 1 1 1 0 1 1 0 0 1 1 0 0 1 0 1 1 1 0 1 0 0 0 0 0 0
