12121323002022202102021002220112
0  2  2  0  3  0  2  2  3  0  0  0  0  2  3  3  3  0  1  1  0  0  0  3  1  3  1  0  1  0  1  2
2 3 1 2 2 2 1 0 1 3 0 1 3 1 3 3 2 1 3 3 1 0 2 2 0 0 1 2 0 1 1 2
2 3 0 3 1 0 2 1 0 3 3 0 0 0 3 0 3 0 2 3 1 1 3 2 3 0 3 0 2 0 2 0
0 1 1 1 1 2 1 3 1 2 0 2 3 3 1 1 2 0 2 3 0 0 2 1 0 2 1 1 3 1 1 0
12201033202332312130310001113112
3  0  2  3  2  1  3  3  2  3  3  0  2  0  1  2  2  2  2  0  1  0  3  2  0  0  3  2  0  0  3  0
1  2  0  0  2  3  0  2  2  2  3  0  2  1  1  0  0  0  1  2  1  2  1  3  1  0  3  3  3  2  0  2
02210120031213313311332110300222
3 0 0 0 0 2 3 0 3 2 2 1 1 2 0 0 2 3 0 0 0 1 2 3 2 0 2 2 0 0 1 0
2 1 2 3 3 2 3 1 2 2 0 2 1 2 2 3 1 3 0 0 0 0 3 2 2 3 2 2 3 2 2 2
0 3 2 1 0 2 3 3 1 2 1 3 3 0 0 3 2 0 0 3 1 3 2 3 3 3 0 2 3 2 3 2
22132003230011211202103113031000
3 3 0 3 1 3 0 0 1 2 3 0 3 1 3 1 1 0 2 3 0 1 0 2 2 2 0 0 2 1 1 0
1 0 2 3 0 1 3 1 3 1 3 3 2 2 3 1 3 1 2 0 3 2 0 0 1 0 0 3 3 0 1 0
2 0 2 0 3 2 1 2 1 3 0 3 2 1 2 3 3 1 2 1 1 2 0 2 2 3 1 2 0 1 2 2
1 0 1 0 1 0 3 3 3 3 1 1 1 3 0 3 2 0 2 2 0 2 3 3 3 2 2 3 1 3 3 0
2 1 3 1 3 3 1 2 1 2 0 1 2 2 0 2 1 2 3 2 0 2 1 1 0 3 1 0 3 2 0 2
2 1 0 1 2 0 1 0 1 1 0 0 2 1 2 2 2 3 0 2 3 0 2 0 2 2 0 1 0 3 3 2
3  3  2  1  0  0  0  3  0  3  1  1  1  3  1  1  2  2  0  2  3  3  0  1  3  3  3  2  2  0  3  0
3 2 0 0 1 1 2 0 2 2 3 2 3 0 2 2 0 3 1 0 0 1 1 2 0 3 3 2 0 0 1 2
0 0 1 2 2 0 2 2 2 2 1 3 3 0 1 3 2 0 3 1 0 1 0 0 2 1 0 2 2 0 1 0
3  1  0  2  0  0  1  0  1  0  0  2  2  0  1  0  1  2  3  2  3  3  3  0  0  0  2  1  3  1  2  0
1 3 2 1 1 3 0 3 0 0 3 1 2 1 0 2 1 0 2 0 3 1 3 0 1 2 1 3 0 2 1 2
22030333023011323220231220322230
1 0 3 1 3 2 3 1 3 2 1 1 1 2 3 0 3 0 3 1 0 1 0 1 1 3 2 1 0 2 0 0
0 0 1 1 1 1 0 1 0 0 1 1 0 0 0 0 1 1 1 1 1 0 0 0 0 0 0 1 1 0 1 0
