013111333202131131030
2 3 2 2 1 1 3 3 3 3 0 0 1 0 0 3 2 2 3 3 2
2  1  2  1  2  0  1  0  1  0  0  2  1  3  0  1  3  0  2  3  2
203101201032121321112
2 3 1 1 0 1 1 0 0 0 3 0 3 1 0 3 3 3 3 3 0
1  0  1  0  0  0  2  0  2  3  3  1  3  0  3  1  1  3  0  2  2
113120112313103100110
2  0  0  3  1  3  2  2  1  2  1  1  0  2  1  1  1  1  0  3  2
3 1 1 2 3 3 3 0 2 2 3 2 3 3 0 2 1 0 1 1 0
1 2 3 2 1 2 0 2 1 3 0 1 0 1 3 2 3 2 1 3 0
122002233313121120330
133322113301131113122
210323332212111200302
002233232220301212302
2 3 0 3 2 3 2 2 0 1 1 1 1 0 3 2 2 3 3 3 0
3 0 0 1 0 3 2 3 1 3 1 1 1 0 0 1 3 1 1 3 2
2 1 0 0 1 3 0 1 0 2 3 0 2 2 3 3 1 2 2 0 2
1  0  3  2  3  1  2  2  3  1  1  2  3  0  0  2  3  0  3  3  2
3  2  2  2  2  3  1  3  0  2  1  2  2  0  2  1  3  1  1  0  0
1  0  3  2  3  0  0  2  2  0  2  1  1  3  1  3  3  3  3  2  0
2 1 3 2 0 1 1 2 3 1 2 0 0 0 3 1 0 1 3 3 0
121303132202022112210
010030310133323031220
1 2 0 2 3 1 1 0 0 0 3 3 2 0 2 3 0 2 2 1 0
0  0  0  3  2  3  2  3  0  1  0  0  3  3  0  1  0  3  2  0  0
3  1  0  1  2  3  0  1  1  2  1  2  2  0  0  2  0  0  0  2  2
3 3 0 3 2 2 2 3 2 0 2 3 1 0 0 2 1 1 0 1 0
2  1  3  3  1  0  2  1  0  1  0  0  3  3  0  2  2  2  1  3  2
011011011001111011000
