3 3 0 3 1 0 2 3 1 3 2 0
2 0 2 3 1 3 1 0 3 3 2 2
0 0 0 3 2 3 0 0 0 3 0 2
3 1 1 3 3 2 3 0 1 1 2 0
312320010312
0  3  1  0  1  2  3  1  0  2  2  2
0 3 0 3 2 0 1 0 3 2 3 2
0  1  2  3  1  3  3  2  1  2  0  0
121000113200
1 1 0 0 1 0 1 2 1 2 0 0
1  2  1  1  1  1  1  2  0  0  3  2
233121000002
1  1  3  0  1  3  1  0  0  3  3  0
1 0 3 3 0 3 1 2 1 2 1 2
2  0  0  1  2  2  0  0  1  2  0  0
202111020100
100133313102
3  3  3  2  0  2  0  0  1  1  2  0
231202131130
1 2 2 3 2 1 1 3 1 2 3 2
1 2 2 1 3 2 1 3 0 1 1 0
123132303310
3 3 0 3 2 3 3 3 0 2 0 0
0  0  0  1  3  1  1  0  1  1  3  0
1  2  0  1  3  2  0  3  1  2  1  2
002300102120
101222133330
101110110110
