1  3  2  2  2  0  3  1  3  0  2  1  2  0  3  0  0  3  0  1  3  2  0  3  0
3  1  2  3  1  2  0  1  2  2  1  1  0  3  2  1  0  3  0  3  3  0  3  1  0
2 2 0 1 3 0 1 2 2 1 3 0 0 3 3 1 3 3 1 1 0 2 2 1 0
2  3  0  1  3  2  0  3  0  0  0  0  0  3  3  0  3  1  0  0  0  0  2  1  2
2  0  1  0  3  1  1  1  2  3  0  2  1  2  2  3  0  1  1  3  0  0  2  1  2
0 3 3 2 0 0 1 2 1 0 2 2 3 3 2 0 0 0 0 3 3 0 1 1 0
1  3  1  1  0  0  2  0  2  2  3  2  2  0  0  3  0  2  1  3  2  3  1  3  0
1  0  1  0  0  3  3  2  0  2  2  3  0  2  1  0  3  0  2  3  3  3  0  2  0
0223023220233202110232002
1 2 1 0 0 3 1 3 1 3 2 1 3 3 3 0 0 1 0 2 1 3 0 3 0
1 1 2 2 3 3 2 2 0 1 0 2 1 2 0 3 0 0 3 1 2 3 2 1 2
2201232003122322120023222
1 1 3 1 1 2 3 0 2 3 1 0 0 1 3 0 1 2 3 2 3 0 1 2 2
0133123110302210320033100
1 3 1 0 3 1 3 1 0 2 2 0 3 1 2 3 0 1 0 0 3 0 3 3 0
1221110211122131212310302
0  1  1  1  1  2  2  1  2  3  1  2  2  3  0  2  0  3  2  3  2  2  1  1  0
2 0 1 2 1 2 2 3 3 1 2 3 1 3 0 2 3 0 3 3 3 2 0 1 0
3  1  3  3  2  0  2  0  0  3  3  2  0  3  2  2  3  1  1  3  2  2  1  3  2
2  1  3  3  2  1  1  2  2  1  3  1  1  2  3  2  3  2  0  3  0  1  3  0  0
2010330203210201213333010
1  0  3  0  0  1  2  0  3  1  3  2  1  0  2  0  1  3  3  0  0  0  1  1  0
1102003121223312222113122
2113321332320022301302310
2321021102023012233111120
3132330302301321302000220
3 3 2 2 0 2 3 2 3 2 1 2 2 3 3 3 3 2 1 1 0 3 1 1 0
3013002203130001002333212
0 3 1 2 2 0 1 1 3 3 2 3 0 1 3 1 2 1 0 1 3 2 1 0 2
2113231312330023323032110
0 0 1 1 0 0 1 0 1 1 1 0 1 0 0 1 0 0 1 0 0 0 0 1 0
