2003331212310032320222202002222310113312
2 1 0 2 0 1 2 2 3 3 0 0 1 0 3 3 3 2 1 1 0 2 1 2 2 3 0 0 2 3 3 0 1 0 3 3 3 1 3 0
3233123030111200001210101113133030310312
2310002323333031201121311023113221000100
3  1  0  2  1  1  1  1  1  2  2  2  1  2  1  2  2  0  1  2  0  1  1  3  2  1  2  0  3  1  1  3  0  1  1  1  2  0  1  2
0 2 1 0 3 2 3 3 1 3 1 2 2 3 3 1 1 2 0 1 0 3 0 1 3 0 2 3 0 2 1 0 2 2 3 0 1 1 1 0
3  2  2  3  3  1  3  2  2  2  1  3  2  1  0  0  1  2  1  1  0  1  2  1  1  1  1  0  2  2  2  0  1  3  0  2  2  2  1  0
0310300311323321200221032231332220232210
1203313133111213131103120302030022222112
3  1  0  0  2  0  3  3  1  2  0  3  1  1  0  1  3  2  2  1  3  2  0  0  1  1  2  1  2  0  1  0  3  0  0  2  2  0  1  2
2122132311103313020211022122133033113200
0 1 0 0 2 2 1 3 2 0 3 2 2 3 1 0 1 2 1 0 2 0 1 3 2 0 2 1 3 2 1 2 1 1 3 2 3 3 3 0
2232102123120030320021022203130000330320
3022033323313202112203212122302231221220
2  2  0  3  0  1  3  1  0  0  0  1  2  2  1  1  2  0  1  1  3  2  3  1  3  0  1  3  3  3  0  2  0  3  2  3  2  0  3  2
0 3 1 3 1 1 3 2 2 2 0 2 2 3 0 1 0 3 3 3 2 3 2 0 2 3 2 3 3 1 2 0 0 0 2 1 0 3 0 0
3 3 2 0 0 0 3 2 2 0 0 2 1 1 0 0 0 0 2 2 0 3 3 0 2 3 0 0 3 3 0 1 2 2 1 0 0 2 1 2
2320120021212320022231312331323012231102
2201321312222022010010230212301220223320
2030001220133303022322113311222101210122
1 2 0 0 3 3 2 2 0 2 2 1 3 2 0 3 3 2 1 3 2 3 1 0 1 0 3 3 0 1 2 1 3 1 2 0 2 3 1 0
0 0 0 1 3 1 0 3 2 2 0 3 1 2 0 2 0 0 2 1 3 2 3 2 0 3 2 3 0 0 1 2 2 2 1 0 0 2 3 0
1 1 0 2 3 1 2 3 3 1 1 1 2 3 2 3 3 2 3 1 3 1 0 3 1 1 2 1 2 1 1 2 3 3 3 2 1 1 2 2
2220301203032120323000223221310022302320
3322221202311101302310021222030210202122
3021322333201222030110303101310221303000
3 2 3 0 2 1 1 0 3 1 3 3 1 2 0 1 1 2 0 1 0 0 2 3 2 3 2 3 0 0 0 3 0 1 2 0 3 1 3 2
0 2 3 2 3 3 0 2 0 2 1 1 1 0 0 3 0 0 0 3 1 0 1 1 1 1 3 3 3 0 3 1 3 2 1 3 3 1 1 2
0101101000011111100011010010011111000010
