3 0 0 0 2 1 2 2 2 2 3 2 2 0 1 2 2 0 3 2 2 2 1 3 3 0 0 3 0 1 3 3 2 0 1 2 0 2
01110123331130101101100320020332332030
30202111130110013221202020132120310020
02031013320320202130111100012030230200
31231321112232101321233322231303030202
30232122130210112121111032121012030020
3  1  1  3  1  3  0  3  0  2  2  2  0  3  0  0  2  1  0  0  3  0  3  2  3  3  1  0  3  3  1  2  0  0  0  2  1  0
1 1 1 0 2 0 1 0 3 0 0 2 3 2 0 0 0 2 2 3 1 2 0 2 2 3 1 3 1 2 1 1 3 3 0 0 2 2
3 3 3 0 2 1 1 1 3 0 0 1 3 1 1 0 0 3 1 1 3 0 2 3 1 3 0 1 3 1 3 1 1 1 2 0 0 0
30320130322202303311033122331130133310
1  1  2  0  0  3  1  0  2  2  0  2  2  0  1  0  1  0  3  0  2  0  1  2  0  3  0  1  0  2  0  3  2  1  0  3  2  0
32102102032332311112102201322132100130
0  1  0  3  2  0  0  2  2  2  2  1  2  0  2  3  0  2  2  2  1  0  1  1  1  1  2  2  1  0  2  1  2  3  1  2  3  0
10322233223022113110230323302112120332
0 1 3 0 0 3 3 0 1 1 2 2 1 3 1 0 0 2 1 3 0 0 3 1 2 2 2 1 1 3 0 0 0 1 0 0 1 0
01100110100001110011001010101110110000
