12100113131201320102
20113033131221323210
0  0  2  3  0  0  0  2  0  3  3  3  0  1  0  2  2  3  1  2
1  3  3  3  0  2  0  3  2  1  1  1  3  1  0  0  0  2  2  2
1 1 3 1 1 2 2 3 1 2 1 0 1 0 3 1 3 3 0 0
23303300210110131110
1 1 0 3 2 1 0 0 0 1 1 1 0 2 2 2 1 1 2 0
03021113130020321202
1 0 1 1 0 1 1 2 2 1 1 1 1 0 3 2 1 3 1 0
33002133121321222000
2  3  1  3  1  1  3  0  2  0  2  1  0  3  1  3  2  3  0  2
2 1 2 1 2 0 3 3 1 3 1 2 3 1 3 2 3 2 3 2
23012122222301233100
1 3 2 2 2 0 2 3 0 1 1 0 1 0 2 2 0 2 0 0
23330021320130111220
1  3  1  0  2  2  2  1  1  1  3  0  1  1  2  2  1  3  0  2
1 1 0 3 2 2 3 2 3 2 2 2 0 2 2 2 2 1 1 0
10001010010010110000
