0  1  1  2  2  3  2  1  1  2  3  3  3  0  2  0  2  3  3  3  2  3  0  3  1  3  2  1  3  2  0
2  0  2  1  1  3  0  1  0  3  3  3  2  0  1  1  2  2  2  2  3  1  3  2  0  3  0  1  0  2  2
2123233202303321220033033310002
2  1  3  0  3  3  1  2  3  0  3  3  3  1  1  0  3  2  1  0  2  1  1  3  1  1  3  1  1  1  0
0030333003232023301031120011100
2 3 0 2 1 3 0 1 1 2 0 1 3 0 0 0 0 2 1 1 3 0 0 0 2 0 3 1 2 1 2
1  1  3  0  0  3  1  0  2  2  1  3  0  2  3  0  0  2  1  1  3  0  1  2  0  0  1  1  1  0  0
1  3  2  0  0  3  1  2  1  2  1  1  0  2  3  2  2  2  1  1  2  0  0  2  1  1  0  0  3  2  2
1311200012002312330302301013220
3322201001103232102311312201000
0  3  2  3  0  3  0  0  1  0  1  0  3  3  0  2  0  0  2  1  1  3  2  3  3  1  3  3  2  1  0
1 3 3 0 2 3 1 3 1 3 0 1 1 0 3 0 2 0 2 3 1 1 1 3 1 3 2 3 0 3 2
2  2  2  0  2  0  3  0  3  0  0  2  1  3  1  1  0  2  3  1  0  1  2  3  2  2  1  3  1  1  0
0  1  1  1  1  0  1  1  0  0  1  0  0  0  0  0  0  1  0  1  1  0  1  0  0  1  1  0  0  0  0
