2  0  0  0  3  0  1  0  1  0  0  2  1  2  0
100303132120310
2 3 1 2 2 1 0 1 3 2 3 2 0 0 0
0 0 1 0 2 3 3 0 3 1 2 3 3 1 0
303320121020112
2 3 0 2 2 0 0 3 3 0 0 2 3 2 0
022000122313010
200200003122030
1  1  1  1  3  2  0  2  2  1  2  2  3  1  0
131320310103202
1 0 0 0 0 2 1 3 0 3 3 1 3 0 0
3  0  1  3  0  0  2  0  2  0  2  0  1  1  0
131121120223202
0  2  2  3  1  1  1  3  1  1  3  3  0  1  2
1 3 1 1 2 1 0 0 3 3 1 3 0 3 0
2  0  2  2  3  3  3  0  3  1  3  2  2  3  2
123212231030102
010202213210330
0 1 3 3 3 3 2 2 0 3 0 1 2 3 0
2  0  3  3  3  0  1  1  1  0  0  2  3  2  2
203001200100302
2 0 1 0 0 0 0 1 0 0 2 2 3 0 2
210110211330220
202033331310132
0  0  0  0  2  1  2  1  2  1  1  2  3  1  0
0 0 1 1 1 0 1 0 1 0 0 0 0 0 0
