0  1  2  3  2  0  1  2  2  2  1  0  2  2  3  1  0  0  2  1  0  0  0
3 1 0 2 2 0 2 2 2 0 2 3 0 3 2 1 3 3 3 1 2 1 2
03201102022322021332030
0 1 1 3 1 2 0 1 0 0 1 2 1 1 2 3 1 3 1 2 1 3 2
0  1  1  1  0  2  2  2  0  2  2  2  3  1  0  2  0  2  1  2  1  1  2
3 0 3 3 2 1 2 1 0 3 2 1 2 3 0 3 2 2 1 2 2 2 0
3  1  0  1  0  3  0  0  0  1  0  1  0  1  1  3  2  2  3  3  3  3  2
21201132010023320231032
1 3 2 3 3 0 2 1 0 3 2 3 2 3 2 1 1 2 0 3 2 3 0
0  1  2  0  3  3  3  1  1  3  0  2  2  2  2  2  2  0  0  1  2  3  0
2 0 2 3 2 0 0 3 2 1 3 1 0 3 0 3 0 0 1 3 2 0 2
2 2 0 2 0 3 2 3 0 1 3 2 2 0 2 0 3 3 2 2 0 1 0
00032120010023003021130
1 2 0 0 1 2 3 1 1 3 3 2 2 1 0 2 0 3 2 3 0 2 2
1 0 1 0 2 2 2 1 1 2 2 0 0 0 3 3 3 3 0 2 2 0 2
0 3 3 0 0 2 2 0 1 1 2 2 0 3 2 1 2 3 3 1 2 1 0
0  0  2  0  0  1  0  3  1  3  1  0  3  2  3  0  2  0  2  0  0  1  0
1 0 3 1 1 3 0 3 1 0 3 0 1 3 1 3 2 2 1 2 2 0 2
11113023110332103203110
3  3  2  2  1  2  0  0  1  0  1  0  2  0  1  1  2  0  0  1  0  0  0
2 1 3 3 3 2 1 0 1 1 1 2 2 2 3 2 1 2 3 3 2 3 0
23231202233311133322300
33030320212110111210310
3 0 3 2 0 3 1 0 2 1 3 0 1 3 3 2 2 2 0 1 3 2 0
23233112300010032310202
1 1 1 2 1 1 1 2 0 3 3 1 1 1 1 0 1 2 2 1 1 0 0
1 0 0 0 0 1 0 1 1 0 0 1 1 0 1 0 1 1 1 1 0 1 0
