133232133321322220033030131013002
3  3  0  0  1  0  0  3  2  2  3  2  1  2  1  2  1  2  1  1  1  3  1  0  1  3  1  3  2  3  1  0  0
0  0  1  2  0  1  3  2  1  2  2  1  1  1  0  2  1  0  3  1  0  3  2  2  1  1  0  0  2  0  1  2  2
333330323132322233131231211010100
310223132113202311020303110323120
2  1  2  2  2  0  1  0  1  1  1  3  3  3  2  1  3  2  2  0  3  3  0  1  2  3  2  1  3  3  0  2  2
3  1  1  0  2  3  2  1  3  3  0  3  0  1  1  3  0  1  0  0  2  3  2  2  0  2  2  2  1  3  2  1  2
1 0 2 2 2 3 3 3 3 1 1 0 2 3 1 0 1 3 0 3 1 2 0 2 1 2 2 0 0 3 3 3 2
130202332302031113002323222320020
3  3  2  3  2  3  2  3  1  2  0  0  0  3  1  1  2  3  1  2  3  3  2  0  2  2  2  0  0  1  3  1  0
201302311011001300023131313011310
3  3  2  0  1  1  0  2  2  1  0  2  0  1  0  1  0  1  3  3  2  1  1  1  3  3  1  1  2  1  0  3  0
0 1 3 3 3 1 1 2 2 2 0 3 1 2 1 0 0 2 0 3 0 2 3 3 1 2 0 3 2 3 3 3 0
1 0 2 2 3 2 1 2 1 3 2 2 3 0 3 1 0 2 1 0 1 1 3 3 0 2 0 1 3 2 1 1 0
1 3 1 2 0 3 1 0 3 2 0 0 3 2 3 1 2 3 1 3 1 1 1 0 1 3 1 3 0 3 1 0 0
3 2 3 2 1 3 0 0 3 2 3 1 0 3 0 2 3 3 3 0 1 2 1 1 1 1 3 1 3 1 1 0 2
1 2 3 0 2 2 0 0 2 3 2 2 2 0 1 3 1 3 0 1 3 2 1 0 1 1 0 1 0 0 2 3 2
222012033002302202010320111222030
110100001000110011100100011011010
