33031111231122131120033330331310
3 2 1 0 3 2 1 2 0 2 0 1 1 2 1 3 0 3 3 2 1 1 2 0 3 1 2 3 0 0 1 2
2  2  1  2  2  1  1  1  1  1  1  1  1  2  1  1  2  2  0  0  1  0  3  1  0  1  1  2  3  0  3  0
32120321112110320001101322223230
2 2 0 2 0 3 2 1 0 0 0 3 0 1 1 0 2 0 3 3 2 2 3 3 1 2 1 1 1 0 0 2
1 0 1 3 0 2 1 1 1 1 1 3 3 3 1 0 3 0 0 2 2 2 3 3 2 0 3 1 0 0 2 0
3  3  0  2  1  0  3  3  1  1  3  0  2  2  3  0  0  1  1  0  2  1  3  3  1  2  1  3  1  3  1  2
3 2 3 1 1 3 3 2 2 3 3 2 0 1 3 2 0 2 3 0 2 3 0 0 2 2 3 3 3 3 3 2
0  3  2  1  2  1  1  0  3  2  3  0  2  1  0  3  2  0  2  1  3  2  3  1  3  1  3  3  3  2  0  2
3 3 2 0 1 1 2 0 3 0 0 0 2 1 2 0 0 2 0 0 2 3 1 3 3 3 3 0 2 0 1 2
3  2  0  3  0  2  1  3  0  3  2  3  1  2  0  2  2  3  3  1  1  2  1  3  2  1  1  0  2  2  1  0
13032212201322030220102032013310
0  2  1  0  0  1  3  1  2  1  2  3  3  2  2  2  0  2  1  1  2  3  1  2  3  1  3  1  2  1  2  0
3  0  0  1  3  0  1  3  1  2  3  0  0  0  2  2  3  3  3  0  2  0  3  0  0  2  0  2  0  3  3  0
3  1  3  0  1  1  1  2  3  3  1  0  2  1  2  2  1  2  3  1  3  0  1  2  3  2  3  1  2  2  3  2
02113100031230133022220230112322
12130132200110122222022301000220
0 0 0 1 1 1 3 2 3 2 2 1 3 3 0 2 2 0 2 1 0 1 1 0 0 3 2 3 0 3 0 0
1  1  0  0  3  0  3  1  1  2  2  0  2  3  0  3  0  0  1  1  1  2  3  0  1  1  3  3  3  3  3  2
10312200000002311322300111331102
2  3  2  0  2  2  2  0  1  3  3  1  0  3  0  2  3  0  0  3  3  0  0  3  0  0  3  3  0  0  0  2
2  0  3  0  0  3  0  2  3  2  2  2  1  0  3  0  2  1  0  2  2  3  2  0  3  0  3  3  3  0  0  0
01121022300020310000322100231210
3  3  2  2  2  2  2  2  3  0  2  2  3  0  3  3  3  3  3  0  1  2  1  3  1  2  2  2  0  0  3  0
3 1 1 1 2 1 1 3 0 2 0 0 3 0 2 1 0 0 1 0 1 2 0 1 2 3 0 1 0 0 3 2
3  3  3  1  0  3  3  2  2  1  1  1  3  2  0  3  0  2  1  1  3  0  2  0  1  3  0  1  2  1  0  2
02213110212320000121011230002230
31300330100130002002002032120132
3  3  2  0  1  1  3  3  0  3  1  3  1  3  3  2  0  1  3  3  3  3  2  3  0  1  0  2  1  2  3  2
3  3  1  2  2  3  1  3  0  1  0  3  0  1  1  1  2  3  3  1  3  3  1  2  3  0  2  0  1  2  2  0
0 0 1 0 0 0 1 1 1 1 1 0 0 1 1 0 1 1 0 1 1 1 0 1 1 1 0 1 1 0 0 0
