2231330133231212223133111021332010000102
0 0 1 1 0 2 0 3 0 1 1 0 1 1 1 1 0 0 3 0 0 0 3 0 1 1 2 2 1 2 1 3 2 0 1 1 3 0 1 2
2320200021331102020012213110131001002000
2  1  1  2  2  2  3  1  0  2  2  3  3  1  0  1  3  2  2  3  0  0  3  0  1  3  3  2  1  1  0  2  3  2  2  3  0  1  3  0
3101213110022022311001313303233103323000
0  2  2  1  2  2  3  2  1  2  3  0  2  1  2  2  1  0  2  3  0  1  2  1  3  2  0  1  1  3  0  3  0  1  0  2  3  2  1  2
2 1 3 3 1 0 1 2 3 1 1 1 3 2 1 0 0 2 2 0 1 0 2 0 3 3 3 3 3 1 3 2 2 3 2 0 3 1 2 0
3  3  1  1  2  3  0  3  2  3  1  2  1  1  1  0  1  0  0  1  1  1  0  2  2  3  0  0  0  2  0  0  3  1  0  1  0  3  3  2
2203310213313010123011003313123302331202
0 3 0 1 2 0 0 3 2 2 2 3 3 2 1 2 2 2 0 2 2 3 0 2 0 3 1 2 1 0 0 0 3 1 2 1 0 1 3 0
0110103003003311210031302312022032301300
0  0  2  2  2  3  1  0  3  1  1  3  2  2  0  1  2  2  2  2  0  0  3  0  1  0  2  3  1  1  0  2  2  2  0  2  2  1  0  2
0333023223122133302311202301200011220100
3 0 2 3 3 1 3 1 3 2 1 1 3 0 2 1 1 2 3 0 3 3 3 3 3 1 0 0 0 0 1 0 3 2 0 1 3 0 2 2
0  2  1  2  0  3  1  0  0  2  2  1  3  1  0  1  1  2  2  0  1  3  3  3  0  0  2  2  3  1  0  0  3  0  0  2  2  1  3  2
1012002022111122030022322131101101021022
1  0  1  0  2  2  3  1  3  1  2  3  3  1  2  3  0  2  2  1  2  0  0  0  2  3  3  1  2  2  2  0  3  3  1  0  0  0  1  2
1 0 1 1 1 0 1 1 0 1 1 0 0 1 1 0 1 1 1 0 1 1 0 0 1 0 1 1 1 0 1 0 1 1 0 0 1 1 1 0
