1  2  1  3  1  0  2  1  1  0  0  1  1  1  2  1  2
12022100021010122
30100200001333010
2  3  1  0  3  3  1  0  1  1  3  1  3  0  1  3  2
03112313321320332
3 1 2 3 3 2 0 1 1 3 1 3 3 1 1 3 0
3  0  0  2  2  3  1  0  1  3  3  2  2  1  3  0  0
00012023022000010
1  0  1  0  1  1  1  0  1  1  0  1  1  0  0  1  0
