1 0 2 1 3 2 0 1 1 3 0 2 0 2 2 2 3 1 1 2 1 2 1 2 2 2 3 3 3 3 0 0 3 3 1 1 2 1 2
1  3  1  3  1  2  0  3  0  0  1  3  0  0  2  0  3  1  2  0  0  1  2  1  1  2  0  2  2  1  3  3  1  3  0  1  3  3  2
3 2 0 0 3 1 3 1 2 2 0 1 0 2 2 2 0 0 2 3 0 1 0 2 2 3 3 0 1 0 0 0 0 0 2 3 0 3 2
033322210321323233210033201023311211020
003202023320011232122100311311212223102
1 0 2 1 0 0 0 3 1 0 3 0 3 0 1 1 0 3 1 2 0 2 0 1 2 0 3 0 0 0 3 0 0 2 2 0 2 3 2
1 1 2 2 2 0 2 1 3 0 1 0 2 1 2 3 2 1 1 0 3 2 3 2 1 1 1 3 3 1 0 1 1 3 1 2 0 3 2
3 0 2 3 1 3 3 0 2 1 0 0 2 0 1 0 1 1 0 0 1 0 1 0 1 2 0 2 1 0 0 3 2 3 1 1 0 0 2
0 3 3 1 0 2 2 2 3 2 2 0 1 1 2 0 3 2 1 0 1 3 2 0 1 2 2 2 2 1 2 2 2 1 1 2 3 1 0
011032220231132100213110121300320232100
3 3 1 2 2 3 3 3 3 1 0 3 1 1 0 0 0 1 0 1 1 3 2 0 1 2 0 0 0 0 3 2 1 1 1 3 0 2 2
2  0  3  3  1  0  0  1  0  0  3  1  1  1  3  0  0  3  1  1  0  1  1  1  3  3  3  0  2  1  3  3  2  3  1  2  1  0  2
3 2 2 2 1 0 1 1 0 0 1 1 3 1 2 1 3 1 1 2 1 1 1 0 0 3 1 1 3 3 2 3 0 3 1 3 2 0 2
111100111010110011001101110010001010010
