1  0  0  3  2  0  3  1  1  3  2  1  3  1  0  2
1331112223331100
0213323232001310
1011220133122230
0033201302303212
2120210310200010
0 2 2 2 3 2 0 1 0 1 0 3 0 0 1 2
3 0 3 2 0 0 2 3 1 1 0 0 1 3 2 2
2 0 1 1 0 1 2 3 3 3 0 0 1 3 3 0
1 0 3 0 2 3 0 2 2 0 2 1 0 1 2 0
1 3 3 0 0 1 2 1 1 1 3 0 3 0 3 2
0032312331313102
2010201022133030
0333203132200300
0 0 1 3 1 2 1 0 3 0 1 1 3 1 3 2
0112012122333302
1  0  0  0  0  0  0  1  1  3  0  2  0  0  2  0
2 1 3 1 3 3 1 0 2 2 0 3 3 0 2 2
1 0 3 0 3 0 2 0 0 1 0 3 0 0 3 2
3 1 0 3 1 2 2 3 3 3 0 0 0 0 3 2
3  2  2  0  3  3  2  1  3  2  0  1  1  0  3  2
3 2 2 2 3 0 3 2 2 3 0 3 1 3 3 0
2  2  0  1  2  1  1  3  0  2  0  1  3  0  3  0
2203101012110130
1 0 1 3 1 2 2 2 0 0 1 0 2 2 2 2
2 2 2 3 1 3 2 1 2 3 3 3 0 3 2 2
0121033113130002
3 1 1 1 2 2 1 3 1 3 0 2 0 3 3 2
1 0 0 0 1 1 1 0 0 0 0 1 0 0 0 0
