30110012131302
3 1 0 0 2 1 2 2 0 1 0 2 2 0
13321200033322
2 2 3 1 2 2 3 3 0 3 0 0 2 2
1  2  1  3  2  1  2  1  0  1  2  2  0  0
02211301202132
22011033220112
10301100023312
33202113332122
3  3  3  1  2  2  0  1  1  0  2  2  3  0
33230031120302
11311233032130
2  1  1  0  1  1  1  2  3  0  1  2  1  0
13133203033222
23333102212012
1 2 3 0 1 1 0 1 1 2 0 2 2 2
2 2 0 2 0 2 1 3 1 2 3 0 2 0
21133321110230
11111111010010
