0 3 3 3 2 0 0 2 0 3 0 3 2 3 3 3 0 2 3 0 1 0 2 3 3 3 2
212333333311312202320331312
211233102012101322133320212
3 1 3 1 3 1 2 0 2 2 0 3 1 3 3 0 1 3 2 0 1 2 3 1 1 2 0
0 0 3 0 3 0 0 2 3 2 3 3 2 2 2 0 0 2 3 0 2 3 3 1 0 1 0
2 2 1 0 2 0 3 1 3 1 2 3 2 0 1 0 3 2 3 1 3 3 2 3 0 2 2
3 1 0 0 0 2 1 1 2 0 1 0 0 3 1 3 1 2 2 1 2 2 1 3 3 2 0
2 2 3 0 1 1 1 3 2 3 2 3 1 3 3 2 3 3 2 3 3 2 1 1 2 3 0
332101222011132120220221200
0  0  3  0  1  3  3  1  3  0  2  1  2  0  2  3  3  1  2  1  3  1  2  3  0  0  0
1 0 0 0 2 2 3 1 0 1 1 3 1 2 0 1 2 0 2 1 1 1 0 2 0 1 0
3 2 2 3 2 0 3 2 3 1 3 0 2 1 0 1 3 2 2 1 0 2 0 2 2 1 2
2 1 1 3 3 1 0 2 0 0 0 1 2 3 1 1 3 1 0 1 3 1 3 0 0 2 0
330103330331000231112211212
3  2  0  3  0  1  3  0  3  0  2  2  2  3  0  1  3  2  2  2  3  2  0  2  3  3  0
131313122313020113222130230
1  3  0  2  3  2  0  0  3  2  0  3  1  0  0  2  2  3  2  0  2  2  3  3  3  1  0
1 3 2 2 0 1 3 0 2 0 3 0 2 3 0 0 2 1 2 0 1 3 3 3 1 0 0
111010011111001011101101110
