2  2  0  0  0  1  2  0  1  3  0  3  3  0  1  0  2  0  2  3  0  0  3  0  0  3  0  2  2
12120331112133332102322000332
0 2 3 1 2 1 3 2 0 2 2 0 0 2 2 2 0 1 1 1 1 3 2 3 3 2 1 3 0
1  3  2  2  3  3  1  0  2  0  1  0  3  0  0  3  2  0  1  3  1  1  3  1  0  0  1  2  0
2  0  3  0  0  1  1  2  2  2  0  3  3  2  0  2  3  3  0  3  3  3  1  3  3  1  1  0  2
2 1 0 1 0 0 3 3 1 0 0 2 2 2 0 1 1 1 3 3 1 3 0 3 3 3 0 1 0
1  3  0  3  3  2  1  2  1  3  1  3  0  3  1  1  1  0  3  3  3  2  3  1  2  3  1  1  0
2 0 2 3 1 1 3 3 0 0 2 0 2 0 3 0 3 2 0 1 0 0 1 2 3 0 3 3 2
0  3  2  2  2  2  0  0  3  3  1  0  0  3  2  3  0  1  1  3  1  3  3  2  1  1  2  2  2
0  3  3  0  1  1  1  0  2  2  0  0  2  2  3  1  0  2  1  2  0  2  1  2  2  2  0  3  0
2 3 0 2 3 3 0 0 2 3 1 1 0 2 2 0 0 1 2 0 3 1 2 0 2 0 3 3 0
3  3  0  1  1  2  1  1  2  2  1  3  3  1  3  3  1  0  0  1  3  2  3  3  2  0  3  1  0
1  0  1  2  2  3  2  2  3  0  3  1  3  0  2  0  2  3  2  1  0  1  1  3  1  2  0  3  2
0  2  3  1  1  1  1  3  3  2  1  2  3  0  2  1  0  2  0  1  1  2  0  3  0  0  3  1  2
1 0 0 1 1 0 3 3 3 2 0 2 0 1 2 0 2 0 3 1 0 2 3 1 1 3 2 3 2
1  3  2  0  2  2  0  1  0  1  1  1  3  1  2  0  2  0  2  1  0  2  1  2  1  2  1  2  0
3  0  2  2  1  1  1  1  0  1  1  3  2  1  0  3  3  3  0  0  1  0  3  0  2  2  0  0  0
32312222133032021200102132020
3 3 0 2 3 1 1 2 2 3 1 1 0 1 3 2 2 2 2 2 3 1 3 1 3 1 1 2 2
10221332202000132333313312300
10210321213103230210103203202
1 2 3 1 1 0 1 1 3 1 3 0 0 1 2 2 3 0 0 3 1 0 1 0 0 3 0 3 2
0  1  1  3  1  0  2  1  1  2  0  3  3  2  3  3  3  3  2  3  1  0  1  1  3  2  0  3  2
1 0 2 1 0 2 2 0 1 3 2 3 2 0 1 2 3 1 0 0 3 2 3 1 2 1 0 2 2
0 0 1 0 0 1 0 1 0 1 1 1 0 1 0 0 0 1 0 1 1 0 1 1 1 0 0 1 0
