1323021123213023000023232300232
1  0  2  1  2  3  2  3  2  0  3  1  1  3  2  3  0  3  1  2  1  3  2  0  3  2  3  1  0  1  0
1  2  3  3  2  2  3  2  1  2  2  2  0  3  1  2  1  1  1  1  0  3  3  0  2  0  3  2  3  2  2
0  2  3  3  2  0  1  3  2  2  1  2  1  1  1  3  3  3  0  3  0  2  2  2  0  1  0  2  3  2  2
2  1  0  3  0  1  3  3  3  3  3  2  3  0  2  0  1  0  0  2  1  2  0  3  0  1  0  2  1  2  0
1131022233301321132022213321212
1 2 3 2 0 0 2 3 2 2 2 2 0 3 1 3 2 0 3 1 0 2 3 0 0 1 3 1 3 0 0
3220210121203312232002313210300
0 3 2 0 1 3 3 2 0 1 2 0 2 0 1 1 1 1 0 3 1 3 3 3 2 0 0 1 1 3 0
2  2  2  3  0  0  3  3  1  0  2  1  1  0  0  2  1  0  3  2  3  0  3  1  1  0  1  2  3  3  2
2 0 0 1 2 2 0 1 0 1 1 0 1 3 2 2 0 1 2 2 2 0 1 3 0 1 1 2 3 1 2
2321210102032012203101303213032
1322111331022003013001123312032
0 3 2 2 2 0 3 1 0 3 1 3 0 0 0 3 3 2 2 0 3 2 1 3 0 1 0 0 3 1 2
3  0  0  2  3  3  3  3  2  3  2  0  3  0  3  3  0  0  3  0  3  2  1  2  1  3  1  3  1  0  0
3  2  0  1  3  1  3  0  2  2  2  2  3  2  3  2  2  3  0  2  0  3  2  1  2  0  0  2  0  0  2
1 2 0 0 2 1 1 3 2 0 1 1 2 0 0 1 1 2 1 0 1 1 1 2 3 0 1 0 2 0 2
0  1  0  3  3  2  1  1  1  2  2  2  1  0  2  1  1  3  3  3  0  2  3  0  0  1  3  1  0  0  2
2213013302301100222121322220230
3  0  3  3  2  1  2  3  2  0  1  0  3  1  0  3  2  2  2  2  2  2  2  1  2  1  2  1  0  1  2
2  3  3  3  0  3  0  0  2  0  1  1  2  3  1  0  3  3  1  0  1  3  0  2  0  2  0  2  3  1  2
1  3  1  3  1  1  2  1  1  1  0  0  1  2  1  1  0  3  3  0  0  1  3  0  3  1  1  2  3  0  2
1  0  1  0  2  0  3  2  2  2  1  0  0  2  1  3  1  2  0  0  1  3  1  1  3  1  2  1  2  2  0
0  3  1  1  0  1  2  2  3  3  2  2  1  2  1  2  1  0  2  3  1  2  3  0  3  2  3  1  3  0  0
2311003122103101200012301222100
2211133203323223101122110112202
0 1 1 1 1 0 0 0 0 0 0 1 0 1 1 1 1 0 1 1 0 0 1 1 1 1 1 1 1 1 0
