2131202112
1 0 1 2 0 1 0 1 2 0
1  0  0  2  0  1  2  2  2  2
2122211332
0 0 0 2 0 2 1 0 0 0
1331003212
1 2 0 0 0 2 1 0 0 0
2213100332
3  2  3  0  2  0  0  3  0  0
0  1  2  0  2  0  2  3  3  0
3  1  3  2  0  1  2  2  1  0
0201203332
0220112012
1310010012
3 0 3 0 2 2 2 0 2 0
3 2 2 0 1 2 3 0 3 0
1000110110
