3 3 1 3 0 3 0 0 2 1 3 2
320300213032
2 1 2 1 3 2 0 1 3 1 0 0
0 2 0 2 0 1 3 3 2 2 0 0
0  1  3  1  1  3  2  1  2  2  0  0
3  1  1  1  3  2  1  2  2  3  2  0
230031101102
0 1 1 0 1 1 0 0 1 1 1 0
