2  1  3  2  3  3  1  0  0  0  1  1  3  2  3  2  0  0  3  0  1  3  0  1  0  2  0  1  2  3  1  0  0  2  0  2  0  0  2  0
0  1  1  2  0  3  3  0  2  0  0  2  3  1  3  0  2  3  2  3  1  1  0  0  2  2  0  0  2  2  1  2  2  0  3  3  1  0  2  0
3  3  3  1  2  1  3  3  0  3  2  0  0  3  3  1  3  1  0  1  1  2  2  2  1  3  3  1  1  1  3  2  2  3  2  3  1  0  3  2
1312303332133210032301231200220021032232
3  1  3  3  3  3  3  3  3  0  1  2  0  3  2  2  2  1  3  3  2  2  2  2  3  0  3  1  3  1  1  1  3  1  2  2  0  3  2  2
1 3 0 3 1 1 3 3 2 0 0 2 3 1 0 1 1 3 1 1 1 1 3 2 3 3 2 2 0 3 2 0 0 2 3 0 1 2 1 0
1  1  1  2  3  1  0  2  0  1  2  2  2  0  3  1  1  2  2  1  2  0  3  1  0  0  0  3  0  2  2  1  3  2  1  2  3  0  3  0
3310032033311232211110201002222200212330
0 1 0 0 1 2 3 3 0 3 0 1 3 3 2 2 3 1 3 1 2 3 0 1 1 2 0 3 0 3 3 3 1 0 0 3 2 1 1 2
3310133123320331110132230100131200323112
3 2 1 3 1 0 1 0 2 2 1 2 2 1 1 0 3 3 3 3 2 3 1 2 1 0 2 1 0 1 3 3 1 1 1 1 2 2 0 2
3  3  3  1  3  1  1  0  0  1  2  1  2  1  0  3  3  0  2  0  3  2  2  3  3  1  2  2  2  0  3  3  0  2  3  1  1  3  2  0
2 2 3 1 0 2 3 3 0 3 0 3 2 0 0 2 2 1 3 2 3 2 3 2 3 1 0 3 0 2 3 2 3 3 0 3 0 0 2 2
1  2  2  3  0  2  0  2  3  3  2  1  3  3  3  0  2  3  3  0  3  1  0  3  3  2  3  0  3  2  1  2  3  1  3  1  0  3  0  2
0311131010322110313002133231121113013012
3132213020223201332322020303103121213310
1231203302011132022021033133321122133330
0 1 3 1 0 3 1 0 0 2 0 2 0 3 0 2 0 1 1 1 0 3 0 3 0 1 3 2 1 3 1 0 1 2 2 1 1 3 1 2
0000010110101010100010010000101101100000
