1 2 1 1 1 1 3 0 2 3 1 2 1 2 2 1 1 3 2 0 1 0 3 2 3 1 3 3 3 3 3 2 3 2 0 0 0 3 2
003200131032010200231332130221011203332
1  0  0  3  1  2  3  0  1  2  0  3  2  0  3  3  1  1  0  2  1  1  1  0  2  0  2  1  0  2  3  0  1  3  0  1  0  0  0
1  0  1  0  1  2  3  2  3  1  0  0  3  1  0  2  2  1  0  3  3  0  2  2  3  1  0  0  1  3  0  0  1  0  3  1  2  1  2
3  2  2  3  2  0  3  0  3  1  3  2  2  3  0  3  2  0  0  2  1  3  3  0  0  3  3  2  3  1  2  0  1  2  3  0  2  0  2
1 0 2 1 3 3 1 3 3 1 1 3 2 2 2 3 0 1 0 2 1 0 1 2 3 3 3 3 0 1 3 3 1 3 0 0 0 0 0
3  0  3  1  1  2  3  3  0  1  1  1  1  0  1  0  3  0  0  1  1  1  1  1  2  1  3  2  2  3  2  3  1  3  2  1  3  0  0
2  2  2  3  3  0  1  3  0  3  1  2  1  0  0  3  2  3  1  0  1  1  3  3  3  1  0  1  2  3  1  2  0  2  0  2  0  0  0
2 0 3 3 2 2 1 0 1 0 2 0 1 2 0 2 2 2 3 0 3 3 0 0 2 2 3 2 3 0 2 1 2 1 0 2 3 0 2
031101013220000231103133110303332121112
211100333302220320033223321321300012022
130102210300301002130120201110111131212
3  2  0  2  1  1  2  0  0  2  2  2  3  2  3  2  3  0  2  3  0  0  3  3  3  3  3  2  0  1  1  1  1  3  2  3  1  0  0
220033112032100200121213232123322223000
1 0 1 1 0 1 1 0 0 0 0 0 0 0 1 1 0 0 0 0 0 0 0 1 0 1 0 0 0 0 0 1 0 0 1 1 0 0 0
