1  0  3  1  0  3  2  2  0  1  1  3  2  2  1  2  0  2  3  0  3  0  1  1  1  0  0  2  1  1  1  0  3  1  3  2  3  0  2
011213021203011013003313021203211323022
1  2  3  1  3  0  0  2  1  0  2  0  0  1  2  3  3  0  0  0  2  2  2  3  0  0  3  1  0  0  0  1  2  2  3  2  3  3  0
3 0 3 2 1 3 0 3 1 2 3 3 1 1 1 3 0 2 1 1 3 3 1 3 0 0 0 2 1 1 3 0 1 0 2 3 1 0 0
330302132113102031120121330003020023212
301322102321003131131033223331010111200
100022110303131031122210132101222103232
321212111223332103120230021223010022120
3  1  1  0  1  0  2  2  3  3  0  1  3  3  1  3  3  1  0  0  3  2  0  3  1  2  1  1  1  3  1  1  3  1  2  2  2  2  2
0  3  1  0  1  1  2  3  0  3  1  3  1  0  1  1  0  2  3  1  3  1  0  3  0  2  2  0  1  0  0  2  1  2  0  0  2  3  0
1  2  3  0  2  2  2  1  0  0  2  3  2  1  1  2  0  1  1  3  2  3  1  3  1  1  2  1  0  0  0  0  1  2  1  2  1  3  0
302132331321300222200130103321121230012
020020132331122113103211302033301312012
023223013332332033122100110013310000020
0  1  0  1  3  1  3  3  1  3  0  1  3  1  2  2  2  1  2  2  2  3  0  1  2  1  2  3  2  2  3  2  1  2  1  0  1  2  0
2  0  1  0  3  3  1  2  1  3  2  1  2  0  2  2  3  0  3  3  3  1  3  2  3  0  1  2  2  3  2  0  3  1  2  1  0  3  2
2  0  3  3  3  2  0  0  3  0  3  1  1  3  0  1  1  0  3  0  3  3  2  0  2  3  2  1  0  0  1  3  2  0  2  3  3  1  2
2 3 3 0 2 0 3 1 3 2 1 2 1 1 0 1 1 3 2 3 0 3 3 0 3 0 3 1 2 0 1 2 2 3 2 3 3 3 0
3  3  3  3  1  2  2  1  3  0  1  3  3  0  2  2  1  0  3  2  1  0  0  0  3  2  0  0  2  2  2  3  3  0  3  3  2  1  2
021321232132023320320330211230200310012
023203130033302203322130001023032033202
0  3  2  0  1  2  2  2  2  3  0  0  1  0  3  3  1  3  1  2  2  1  1  1  2  0  1  1  1  3  3  3  3  2  1  1  2  0  0
3 3 1 2 3 3 3 3 1 3 2 0 2 2 3 2 1 2 3 1 3 2 1 2 2 3 2 1 0 3 0 3 1 1 1 3 3 2 2
0  0  1  0  2  2  2  2  2  0  2  1  3  2  2  3  0  0  3  2  0  1  0  1  2  2  3  3  0  2  0  1  1  3  3  2  1  2  2
001110000111011011010010101011011101110
