01201121110
0 1 3 1 2 2 1 0 0 1 0
32130032030
1  0  1  3  2  3  2  3  2  2  2
1 1 0 1 3 3 3 1 0 2 2
22031312330
30300200210
0  1  3  3  2  1  3  3  2  3  2
02311333012
0 0 0 1 1 0 1 1 1 0 0
