2  1  1  2  3  1  1  1  1  2  3  1  0  0  2  2  3  2  1  3  2
0  1  2  0  3  3  2  0  3  0  2  2  2  2  2  1  0  3  2  0  2
1 2 2 0 2 1 0 3 3 3 3 3 2 2 1 3 0 1 2 1 0
3 0 1 0 3 0 0 0 2 1 2 3 0 1 1 1 3 1 0 1 2
323122300111333103130
3 1 2 1 3 3 3 1 1 3 0 0 3 2 1 1 2 2 1 2 2
0 3 0 0 3 2 3 1 3 1 3 0 3 1 2 0 3 1 1 3 0
3  2  2  3  0  2  2  3  2  2  3  1  0  2  2  0  0  0  0  2  0
2  3  2  1  2  3  2  0  2  2  2  1  1  0  3  0  2  3  2  2  2
3 2 3 1 0 3 2 2 0 0 3 3 1 2 2 1 0 1 0 2 2
001102310331131102130
132030021221231201312
033003023313111333102
1 1 0 3 2 1 2 3 2 1 3 0 0 1 0 2 3 2 0 0 0
033021321312232002030
1 1 1 3 1 2 0 0 3 0 0 1 1 1 0 1 3 1 3 1 0
1  3  0  3  1  1  1  2  1  1  0  1  1  0  1  3  1  1  2  1  0
233232323333123011222
220332110103001030012
310333030333231332102
1 1 2 3 1 3 2 1 3 1 2 1 0 1 2 0 1 1 0 0 0
0 3 3 0 0 2 1 1 1 1 1 2 1 3 0 0 2 1 3 1 2
2  3  3  2  2  0  1  2  1  0  2  2  2  2  0  3  0  2  2  1  2
011001100001111011010
