31203032231303022130300
0 0 2 3 3 1 1 3 1 3 2 3 1 3 3 1 1 2 3 1 1 0 2
3 2 0 3 1 0 0 1 1 3 2 1 3 0 0 3 2 0 2 2 3 1 0
3 0 2 2 0 3 0 1 1 0 1 1 1 0 1 0 1 0 2 2 0 2 0
2  2  3  2  1  0  2  0  3  1  0  2  1  0  2  1  0  3  2  1  2  1  0
11332123203210300310000
2  0  3  3  2  1  1  2  1  2  3  3  3  1  0  2  1  1  3  2  2  3  0
03131022012131320302202
2  3  1  1  2  2  3  0  2  3  1  3  0  1  2  0  0  3  3  2  2  0  2
0 0 0 2 0 0 1 2 0 2 2 0 2 1 0 2 2 2 3 3 0 3 2
00022102102030111232310
20003100131212332001320
1  1  1  0  1  1  0  1  1  1  1  1  1  0  1  1  0  0  0  1  0  0  0
