1 3 2 2 2 0 1 0 0 0 1 2 1 2 1 0 1 2 3 3 3 1 2 1 3 1 0 2 3 3 3 3 3 1 0 0 2 2 0 1 2
1  1  1  3  3  0  2  2  0  3  0  2  1  2  0  1  0  0  3  0  1  2  0  1  0  2  0  2  0  2  2  3  2  1  3  3  0  1  1  0  2
30212231130223002221331030013232022011310
20312133303010232311023233321100232210302
0 3 2 0 2 2 2 3 0 2 3 1 2 1 0 0 1 0 3 2 0 3 3 0 1 3 1 0 0 2 0 1 2 3 0 0 3 3 2 3 0
2 1 1 3 0 2 0 1 1 3 2 2 3 3 2 1 3 3 0 0 1 1 3 2 0 2 1 2 2 2 2 0 1 1 3 2 2 2 2 0 0
1 2 2 0 0 1 1 3 2 1 1 1 3 2 2 0 3 2 0 2 1 3 2 3 2 2 3 1 2 2 3 2 2 2 0 1 1 2 2 3 2
0 0 2 3 1 1 1 1 3 0 1 3 2 3 0 0 3 2 3 3 2 2 3 1 1 2 0 2 2 0 3 1 3 2 0 0 1 3 1 3 0
10223121112232033131222020302130100233032
01013130033103132302113100310001230230230
3  0  2  2  3  0  3  0  1  3  3  0  0  3  3  2  1  2  3  1  3  0  2  3  2  2  0  3  2  1  1  2  1  1  1  0  1  0  2  2  0
3 1 0 2 2 0 1 0 1 3 0 3 1 0 1 3 2 3 0 2 1 1 2 3 2 3 1 3 0 3 0 3 3 1 1 1 0 3 2 2 0
13333102201020300022132001012003133333012
0  1  3  0  0  2  1  2  3  3  0  1  3  1  3  3  0  0  1  3  2  0  2  0  1  0  0  3  1  2  1  3  3  3  2  0  3  0  1  0  0
3  1  3  3  2  0  3  3  3  0  2  2  0  0  0  3  0  3  1  3  2  1  0  1  1  2  2  1  1  3  2  1  2  2  2  2  0  2  0  3  2
2  1  1  3  3  1  1  1  0  3  2  3  2  3  3  1  2  1  3  3  3  2  2  1  0  3  3  1  2  0  1  1  1  3  3  3  0  0  2  1  0
0 2 1 3 0 0 2 3 2 0 2 0 0 2 1 3 0 0 2 1 3 2 3 1 0 2 2 1 2 3 1 2 1 1 0 1 3 3 2 2 2
30330210320230201022020223020203311101220
10001110001000001100101100001100111011110
