10010112212310
2  1  1  0  2  1  3  2  0  1  0  3  1  2
3  3  1  3  3  3  2  3  1  2  1  3  2  2
32301132102010
12230331010232
00203100002022
2  1  0  0  3  1  3  3  3  3  1  1  0  0
2 0 2 0 0 3 3 0 2 3 2 3 3 0
23121222200000
00322321131110
0 3 3 3 3 3 1 2 1 0 3 0 0 2
2 1 2 0 1 0 0 1 2 2 3 1 3 2
1  1  2  0  3  2  2  0  0  2  1  1  0  0
02113323022012
2  0  0  1  1  1  3  2  2  3  3  0  2  2
3 2 3 1 3 2 3 1 3 2 3 0 1 2
13033110223010
01001011101110
