1 2 1 0 1 3 0 0 0 3 2 2 1 3 1 3 3 3 3 0 0 1 1 3 1 2 2 3 3 0 1 0 0
012032120023031103023210011200030
3 0 1 0 0 1 3 0 3 2 0 1 3 0 3 3 3 0 2 3 0 1 0 3 1 1 2 1 0 3 2 1 0
3  2  3  3  0  2  2  3  2  0  2  1  1  0  0  1  2  3  0  3  1  1  1  2  2  1  3  2  0  0  0  2  0
3 0 2 0 1 0 3 1 2 3 0 2 0 3 2 0 3 2 2 3 3 2 2 1 3 2 2 0 2 2 0 0 0
0  0  1  1  2  1  3  1  1  2  3  1  0  3  1  1  0  1  3  1  3  3  1  1  0  1  2  3  3  2  3  3  0
1  1  0  0  2  3  2  1  1  2  2  2  1  2  0  0  2  2  3  3  2  1  3  0  0  3  2  0  2  0  0  0  0
0  1  2  3  3  3  1  1  2  3  1  0  0  3  1  3  0  1  3  0  0  2  3  2  2  3  2  0  3  2  0  2  0
2 1 1 0 2 2 0 3 0 1 2 3 0 3 2 2 3 2 0 0 0 0 0 0 0 0 0 3 3 0 3 2 0
3 1 3 3 2 3 0 2 3 3 1 2 3 0 3 0 2 1 2 2 3 1 1 3 1 1 2 0 0 2 2 2 0
0 2 1 0 2 0 2 0 2 0 0 0 3 0 3 2 2 0 0 0 2 1 0 0 1 3 0 0 2 3 1 2 0
121013212020031321310110301231112
1 3 1 3 2 2 0 1 0 1 0 1 3 0 2 1 1 0 0 2 1 0 1 3 2 0 1 2 2 3 2 3 0
021130212132113102120323003132302
2 1 1 3 2 3 3 2 3 1 2 1 3 2 1 0 2 3 0 0 2 0 2 2 0 0 3 3 1 2 0 3 2
1  1  3  1  1  1  3  2  0  3  3  0  2  1  2  3  0  2  0  2  3  3  3  2  0  1  2  2  0  0  1  2  0
010020323332302002230332210032230
122130220031003300121313022033130
2  2  0  3  0  0  3  2  1  0  2  3  2  3  1  1  1  2  3  1  2  3  1  3  2  3  2  1  3  2  3  0  0
211200210120313111300122300330320
110110000001000000100101011001010
