2  0  2  2  3  3  0  2  3  2  0  3  0  0  1  1  0  3  0  0  3  2  2  0  2  2  1  2  3  3  2  1  1  1  2  0  3  0  2
303012001201021120103312230110133002012
1  0  0  2  3  2  2  3  3  1  3  0  2  1  3  2  2  3  3  0  0  1  2  3  0  0  3  3  2  1  2  3  2  3  3  2  0  0  2
312222303323001020001333203302201122312
030021223332303301100013232122222322130
2  1  0  0  2  1  0  3  1  2  3  1  0  3  1  3  1  2  0  1  1  3  3  3  3  0  1  3  2  2  0  1  2  0  2  0  3  3  2
1  0  3  1  1  3  2  1  3  1  1  1  1  0  0  0  2  3  0  1  1  3  1  2  1  3  0  2  2  0  0  0  2  1  2  0  1  1  2
0 3 0 1 0 0 0 1 0 3 0 3 2 1 2 2 1 2 1 3 0 3 1 0 1 2 2 2 2 3 3 0 2 2 2 0 3 2 2
1  2  0  2  3  2  3  0  1  2  0  2  2  3  3  1  1  0  1  3  3  0  3  3  0  1  1  0  1  1  2  1  2  1  0  1  0  1  0
2 0 2 2 2 1 1 1 1 2 0 2 1 3 3 2 2 1 1 1 0 0 1 1 1 1 3 2 3 3 2 1 2 2 1 1 3 0 2
211031333222020110113223223113203031222
3 1 1 3 0 2 3 3 2 3 3 3 2 1 3 2 2 1 3 2 1 2 3 0 3 3 0 3 3 3 1 3 3 0 3 3 1 0 0
1  1  2  3  2  0  0  3  1  1  2  1  2  1  0  2  2  1  0  0  0  2  1  1  0  3  3  3  1  1  1  2  1  3  0  3  2  2  2
013022000021112300032001133100323100302
2  3  3  2  3  1  0  0  1  3  3  0  3  1  0  0  0  1  3  2  3  3  2  0  0  1  3  3  1  3  0  3  1  1  1  1  3  0  0
130013021221332020320220001222330300210
3 0 0 2 1 1 3 1 0 3 2 3 1 2 3 2 1 2 3 0 2 2 0 2 0 0 3 1 3 3 3 1 2 3 1 2 0 2 0
0  3  0  2  2  0  1  0  3  3  2  0  0  0  3  3  3  3  1  3  0  2  1  2  1  3  3  3  2  2  1  0  3  3  2  1  1  2  0
0 0 3 2 0 2 2 0 1 2 2 1 3 1 3 2 2 1 2 3 0 0 2 3 3 2 0 2 2 0 0 0 2 1 3 0 2 3 0
0 1 1 1 0 0 1 0 0 1 0 0 1 0 1 1 1 1 1 1 1 1 0 0 0 0 0 0 1 0 1 1 0 1 1 0 0 1 0
