020000322303111230012310331100113222
123310222021222030132130311321323132
2 1 1 1 3 0 3 0 0 0 2 0 0 2 3 1 3 1 2 2 3 1 2 0 0 0 3 1 3 2 0 2 3 2 1 0
1  3  3  0  2  3  3  1  1  2  0  1  2  2  1  1  1  2  1  3  1  3  1  1  1  3  2  3  3  1  2  0  1  2  1  2
2  0  0  1  0  0  2  0  2  0  1  2  3  2  3  3  2  2  1  0  1  1  2  1  0  2  2  1  1  2  2  2  0  0  0  0
2 3 1 1 0 0 2 2 3 0 1 0 3 2 3 0 3 1 2 1 0 2 2 1 1 3 1 1 2 1 2 3 0 2 0 0
2 2 1 0 1 1 0 2 2 3 1 1 3 0 2 2 3 1 2 2 1 2 0 2 3 0 1 2 2 0 2 1 2 0 2 0
0 3 2 3 2 2 0 3 0 1 2 1 2 2 3 1 3 1 0 0 0 0 1 3 3 2 1 0 3 0 3 3 0 0 3 2
1 0 0 3 0 3 2 2 1 3 3 3 2 1 2 3 2 1 2 0 0 0 1 2 3 2 2 3 0 1 3 0 1 1 2 0
0  0  2  1  2  3  2  1  3  0  3  1  1  1  0  3  1  2  1  2  3  2  0  3  1  0  1  0  3  2  2  1  2  1  0  0
123001200212101313023133101313100020
0  1  2  0  3  1  1  1  3  2  3  1  2  2  0  2  3  3  3  1  3  3  1  2  3  0  2  2  3  3  1  1  1  1  0  0
330201310003021120201203001333003120
2  1  3  2  0  1  0  1  1  2  1  2  1  0  2  3  2  3  2  3  1  2  3  1  3  2  1  3  3  1  1  2  0  1  0  2
301013233313002132302003200231221300
3 0 0 0 1 3 2 2 0 2 2 3 0 1 2 0 0 1 3 1 3 1 1 3 2 2 0 2 2 1 0 3 2 3 1 2
130312321002202001021222322031001322
2  1  2  3  1  3  2  3  0  1  2  1  1  2  1  1  0  0  0  1  2  2  2  2  2  3  3  3  0  0  2  3  3  1  1  0
221011222013211002130123233210033000
0 2 2 3 0 3 3 1 3 0 3 3 0 0 1 1 2 3 0 2 0 0 1 2 2 0 2 2 1 1 1 0 2 2 2 0
1  3  3  1  0  1  1  0  0  0  3  2  2  2  0  3  1  2  0  1  0  1  1  2  3  3  2  2  3  2  1  1  3  0  3  2
302111230102023332033231120102021302
1 2 2 2 0 3 0 2 1 2 3 3 2 0 0 0 0 0 1 2 1 2 2 1 1 3 3 1 0 2 2 3 0 2 0 2
011202330100223203122310102312131132
001203210230220122230201220320120232
1 0 0 0 1 1 0 1 0 1 0 0 1 1 1 0 1 0 0 1 0 1 0 0 0 0 0 0 0 1 1 1 1 0 1 0
