213231211203302200
120203122213003212
1  1  2  2  3  1  0  1  1  1  2  0  3  3  0  0  3  2
122300132132230200
3 1 1 0 1 0 3 2 1 2 3 0 0 0 2 3 2 0
323312310203201122
3 3 1 3 3 3 2 0 1 2 1 3 0 1 3 3 1 2
3  2  1  0  1  2  2  3  3  3  3  3  0  2  3  0  0  2
012102310212230022
232223212211221212
0 3 0 1 0 3 3 0 2 1 1 3 2 1 3 3 3 2
1  2  2  0  0  2  1  0  1  3  0  3  3  1  0  1  1  0
0 1 0 0 0 1 1 0 0 1 0 1 0 0 1 0 0 0
