03102023133330303023313001031310201210
0  0  2  1  3  3  1  2  2  3  3  0  2  2  3  3  2  2  1  0  1  0  2  3  0  1  0  3  0  2  1  0  0  0  0  2  0  2
2  2  2  0  1  2  1  1  2  3  0  2  2  0  3  1  0  0  2  1  3  1  3  2  0  2  3  2  0  2  0  2  3  3  3  3  1  0
02111131222331101032002123023133310000
10021313220030211310130312312103030102
1 2 2 2 2 2 2 0 0 0 1 1 2 2 2 1 3 1 0 3 2 3 0 1 3 1 0 3 2 0 0 3 3 0 0 1 3 2
13021210123122203211122223323102001002
1 1 2 3 2 3 2 0 2 2 3 1 0 3 0 3 2 0 1 1 2 3 3 0 3 2 1 3 3 0 1 2 2 3 3 2 1 2
1  3  3  0  3  3  0  2  0  2  0  1  3  0  0  2  0  0  0  1  1  3  2  2  2  0  2  0  3  2  0  2  1  2  2  0  3  0
0  1  0  2  3  1  3  0  3  3  3  0  0  0  1  2  0  1  0  2  0  0  2  1  1  3  2  1  2  3  0  2  0  2  2  1  0  0
2 2 0 1 2 1 1 2 0 1 1 1 1 1 1 0 1 0 2 0 1 2 3 2 1 1 2 2 1 2 3 1 1 2 0 2 2 2
00120331111221000131210120320102002030
3 2 0 1 2 2 0 2 3 0 3 0 2 2 0 2 3 2 0 3 3 3 2 2 2 1 0 3 3 2 0 3 2 3 2 1 2 0
3 3 1 3 1 0 3 3 0 3 1 0 3 3 3 3 1 2 3 2 2 3 2 0 3 3 3 0 2 1 2 0 0 3 2 3 1 0
23020231021002201021323233330322232332
30233003021001113322231310323223130022
3  0  2  3  3  0  3  0  1  2  3  3  2  3  3  3  3  1  3  1  1  0  3  3  2  1  0  3  3  3  0  2  1  2  2  3  1  0
33123303233310111111122121013202330230
0  1  0  0  0  1  1  0  1  0  1  0  0  0  0  0  0  1  0  0  1  1  0  0  1  1  0  1  1  1  1  1  0  0  0  1  0  0
