32003112123010232323330213120210030
10311123131003020213223103120301222
23233101202233200332201010303013322
1  2  1  0  2  0  3  0  2  0  1  2  1  1  1  1  0  0  3  0  1  1  0  1  2  2  2  0  3  0  2  0  2  2  0
1  2  3  3  3  1  3  0  2  3  1  0  1  0  0  2  0  1  3  3  0  3  3  1  3  2  1  3  3  1  2  3  3  1  0
33022312110221101003121201223110012
00201011333021113130210311311020310
0  2  0  1  2  3  2  3  1  0  2  0  1  1  0  2  3  3  1  3  1  3  0  3  3  0  0  2  1  3  3  3  0  3  2
1 1 2 0 1 0 1 0 3 2 1 0 2 2 1 1 0 3 2 2 3 2 0 2 1 3 2 2 3 2 3 0 3 0 2
12012133033200311131210032222301302
21032031021031122222030201021020012
1 2 0 3 0 0 1 1 3 3 2 0 0 1 3 1 1 1 0 1 0 3 3 1 0 2 3 2 0 0 1 3 2 3 2
0 2 2 0 0 0 2 0 3 1 0 1 1 1 2 0 2 0 1 2 0 1 0 3 2 0 2 2 3 1 2 0 1 0 2
0  3  0  0  3  3  1  1  2  3  1  3  2  1  1  2  3  1  0  1  2  2  3  2  0  3  3  1  1  3  1  2  1  0  0
02313201320320103120103122331103230
1 3 2 3 2 0 1 2 2 2 3 2 0 0 2 1 0 1 2 1 0 1 1 2 1 0 2 2 0 3 1 0 3 1 0
2  0  2  2  0  2  1  2  2  2  2  0  2  1  0  1  0  0  3  3  3  3  1  2  0  3  1  2  0  0  0  0  2  0  0
1  3  1  3  1  3  0  1  1  1  1  3  2  1  2  2  0  3  1  2  2  0  1  1  1  2  3  3  0  1  3  3  0  3  2
23030312033110200103223121011113310
21011220000321122110120112301221330
3 3 2 2 2 2 2 2 1 1 3 1 0 0 3 0 1 1 1 3 0 2 1 3 2 1 0 3 3 1 1 2 3 2 2
1  0  2  3  2  3  2  2  3  3  2  3  1  0  1  0  3  2  0  3  2  3  2  3  0  2  1  3  1  0  3  2  3  3  2
2 0 2 1 0 3 2 1 1 0 3 3 1 2 3 3 3 1 1 1 1 2 3 3 3 2 2 3 0 0 2 2 1 2 2
2 0 2 1 3 1 3 2 0 3 2 2 3 2 0 1 3 0 0 2 2 2 3 3 0 2 0 0 2 2 2 1 0 0 2
0 2 0 1 0 3 0 1 3 3 2 0 0 2 1 2 3 2 3 3 3 1 3 1 2 3 2 1 1 1 3 3 3 3 0
0 0 1 0 1 0 0 1 0 0 1 0 0 0 1 1 1 1 1 1 1 1 1 0 0 0 1 1 1 0 0 0 1 1 0
