1  0  3  1  1  3  2  0  2  1  0  1  2  1  0  2  2  3  3  0  2  2  2  0  3  3  2  2  3  1  1  2  2  3  3  0
1 0 2 1 0 1 3 3 1 3 3 3 0 3 1 3 2 2 1 2 2 1 1 0 1 3 1 0 0 0 0 0 0 0 1 2
1 3 2 3 0 0 2 3 3 2 2 1 2 0 1 1 3 3 3 1 0 3 3 1 3 1 1 2 3 3 2 3 2 3 0 0
1 0 3 1 1 3 2 3 2 3 2 2 0 0 3 1 2 2 3 2 0 3 3 1 3 3 0 2 3 1 1 2 3 3 1 0
1  0  0  3  1  0  3  0  1  2  2  2  0  3  3  0  0  3  1  3  1  1  2  3  2  1  2  0  2  2  2  0  3  0  3  2
003032202021322101221202021021133100
321302112010023303202312101011122030
0 1 3 3 1 3 2 0 0 3 1 3 3 0 1 0 1 0 2 1 1 3 0 0 3 1 3 1 0 0 1 0 2 2 0 2
310220210302010111100330012020002020
1 2 2 3 1 0 2 1 1 3 3 1 3 3 2 3 0 3 1 3 3 1 3 0 2 1 1 0 3 1 3 2 3 1 3 2
223010013021013003302302002331113100
2 3 2 3 0 1 1 0 2 1 0 1 2 2 2 3 1 1 0 3 1 0 0 1 1 0 2 3 2 1 0 0 1 0 2 2
3 3 2 3 3 3 1 3 2 0 2 2 3 1 2 3 0 1 0 3 2 0 0 2 1 2 2 3 3 1 1 0 2 1 2 2
030012321221020230132321231212311322
1 3 0 1 1 0 3 1 2 1 2 3 1 0 0 1 3 1 3 2 1 3 2 0 2 2 0 0 0 3 3 2 2 0 0 0
030110132330203200010100223112010312
3  3  1  0  3  0  0  3  0  3  2  3  2  2  0  3  2  3  0  1  0  0  2  2  0  3  0  2  1  0  0  3  2  1  2  0
2  3  3  1  3  1  2  3  0  0  2  3  2  0  3  2  3  2  0  2  2  1  0  3  1  1  3  0  3  2  1  1  2  3  1  2
2 0 3 2 1 2 1 2 3 2 2 0 2 0 1 2 3 0 3 2 2 2 1 1 0 2 3 3 1 3 0 0 3 0 2 0
0  2  1  3  2  3  2  0  2  2  2  0  1  0  1  0  2  2  3  2  3  1  2  1  2  0  0  1  1  3  3  3  3  2  2  0
1 0 1 1 0 1 2 0 3 2 0 0 1 0 0 0 2 3 1 3 1 1 1 3 0 2 2 0 0 3 2 3 3 2 0 0
1 0 2 3 3 1 3 2 0 3 2 0 1 1 2 2 2 2 3 2 1 2 0 2 2 0 0 2 3 1 3 2 2 0 0 2
3 3 0 3 1 3 2 1 1 2 3 0 2 3 1 2 1 3 3 3 1 0 1 2 1 3 0 1 1 3 3 0 2 3 0 2
230110302312233132030303031300011312
111202121012123022013122311203223230
033221300331210023101021232202001000
0 1 0 1 0 1 0 0 0 1 0 0 1 0 0 1 1 1 1 1 1 0 0 0 1 1 0 0 1 0 1 1 1 0 0 0
