3 3 3 2 2 0 3 1 2 2 1 3 3 1 1 1 1 0 3 0 3 3 1 0 2 0 1 0
2003102110002221131103123020
2 1 1 3 3 2 1 0 0 3 1 3 3 0 3 1 1 1 2 0 1 1 2 2 3 2 3 0
2 3 2 0 2 0 2 1 0 1 1 2 2 0 2 3 3 3 0 1 2 3 0 3 2 3 2 0
1 2 1 2 3 2 0 2 1 3 0 1 1 1 2 2 0 0 0 2 3 1 1 1 1 0 1 2
0  3  0  1  2  2  0  3  3  2  2  2  0  1  3  1  0  1  2  3  0  2  2  1  0  2  2  2
2122100033232203330220033002
0021023233122120102302303220
2  3  0  3  3  2  1  2  0  0  2  3  2  2  1  3  3  0  2  1  0  3  3  3  1  1  3  0
1 2 3 0 3 1 0 1 0 0 1 0 0 3 2 1 2 1 1 0 2 0 2 1 3 3 0 2
0  2  2  0  0  1  0  0  1  3  3  1  2  0  0  3  1  3  0  1  2  1  0  0  0  2  0  2
3 2 3 2 1 0 0 3 3 1 3 2 2 0 1 1 0 3 2 0 1 1 0 2 2 1 1 2
3 3 3 0 1 1 3 0 3 3 2 1 0 2 3 3 0 1 3 1 0 1 2 1 2 2 0 0
1302133110201013320003133102
2 0 2 0 3 0 3 3 1 2 0 2 1 3 1 0 0 3 3 0 0 3 2 2 2 3 1 0
2 2 2 1 0 1 3 3 2 0 2 2 2 3 1 2 2 1 1 2 2 2 0 1 0 1 2 0
0 3 0 1 1 0 0 0 1 3 3 3 0 1 1 2 1 1 2 0 0 0 2 2 3 1 1 2
2  2  0  1  1  0  2  3  3  3  0  2  2  1  3  0  3  3  2  0  0  2  1  2  3  3  3  2
0 2 1 0 2 3 3 0 2 2 1 1 2 2 1 2 2 2 1 3 2 0 1 3 2 1 2 0
1320133330113313101202123220
0  0  1  1  1  1  1  0  0  1  1  1  0  1  1  0  1  0  0  0  0  1  0  0  0  0  1  0
