1100032133331302123321100200230
1310300320221212133302120011320
2  1  2  2  1  0  1  3  1  3  0  0  0  0  3  2  2  1  1  0  2  0  1  0  1  3  0  2  0  2  0
1  1  3  3  0  2  0  2  1  1  3  2  0  0  0  3  3  0  1  2  1  3  1  2  2  1  2  1  0  2  2
2  1  0  2  3  3  0  1  3  3  1  3  3  3  2  1  2  2  1  0  0  3  2  1  3  2  0  0  3  1  2
3  0  1  3  2  0  2  1  1  1  1  0  2  3  1  1  1  2  3  0  0  0  2  0  2  2  3  3  1  0  0
0122331030311101212232000202302
2220213202021312233120303230212
0300212201013313110232200110220
1 2 1 1 2 3 3 1 0 2 3 3 0 3 3 3 2 2 0 3 3 1 2 1 1 1 3 3 1 3 0
0 2 0 2 3 3 2 3 2 1 3 0 1 2 1 3 1 2 3 2 1 2 1 1 0 1 3 3 0 2 0
0 0 3 0 2 1 3 0 2 0 3 2 0 3 1 0 3 3 1 2 1 1 0 0 3 1 3 0 3 0 0
0  1  1  0  0  1  3  3  0  1  3  2  0  1  0  1  1  2  2  2  0  2  1  0  1  2  3  2  3  1  2
1  3  1  1  2  1  2  0  1  2  2  3  3  0  0  2  1  0  3  1  2  0  3  2  0  2  3  0  0  0  0
2  0  0  1  0  3  1  0  2  3  0  1  3  1  1  1  0  0  0  2  1  1  3  1  1  0  2  2  2  2  0
3  1  0  0  0  3  3  0  0  2  0  1  3  2  1  3  2  3  3  0  2  0  1  1  3  0  2  0  2  0  0
3  2  1  3  3  1  2  0  1  2  0  0  1  2  3  3  2  0  1  2  0  2  3  1  1  0  3  2  2  0  2
2  0  0  2  0  2  0  0  0  2  2  3  0  0  2  1  3  1  2  0  0  2  0  1  0  2  0  0  1  1  2
0100033032322221233122121002230
0201211021333103310220021111200
2 1 2 3 1 0 2 2 1 3 3 3 1 3 1 0 0 1 1 1 0 0 3 1 0 1 0 1 1 1 2
0  3  3  3  3  1  1  1  3  3  2  2  1  0  0  0  1  2  0  2  0  0  0  0  0  3  2  0  1  3  0
1 2 2 0 0 1 3 1 2 3 2 3 2 1 1 3 3 3 0 3 0 0 3 0 2 0 0 0 3 1 2
3301131310031332300323121201222
2 1 0 2 2 0 2 2 1 0 2 3 3 2 2 1 3 3 3 2 3 1 0 2 0 0 0 1 1 1 2
0 1 0 0 1 1 0 0 0 1 1 0 0 0 1 0 1 1 1 0 0 0 0 0 1 1 0 0 0 0 0
