0 0 3 2 0 1 0 1 3 0 2 0 3 3 0 2 2 2 2 3 1 2 0 0 2
3133102210133123300212130
1 2 3 3 0 1 2 2 2 3 3 0 3 3 1 1 0 1 2 0 1 1 1 0 2
0330101212231120102201002
3030332211123220002001320
3300123012123101230033100
2222311210033030320001220
1020201113311320323211330
2320233113300211303123132
1  0  0  0  3  0  0  3  3  0  3  3  0  2  3  1  2  2  3  1  2  2  3  2  2
2 1 3 2 0 1 0 3 2 2 3 2 3 1 3 2 3 3 2 2 2 1 1 3 0
3311113022123031003122002
3233100030011023210223302
2210103111123123202323120
2 0 3 2 0 2 1 0 1 0 0 3 2 3 2 0 2 2 0 2 2 2 3 2 2
3130123200110001130222132
3133113321120101301120022
1113130213310310200111100
3  3  2  2  3  2  0  1  1  1  2  2  1  2  0  0  2  3  1  2  1  3  2  2  0
0 0 2 3 0 3 2 2 2 0 3 1 0 2 3 0 2 3 2 3 3 1 0 1 2
3  0  0  2  3  3  0  2  2  2  3  0  0  0  3  1  0  2  0  0  0  3  1  2  2
0000020132332300200010212
1 0 2 0 2 3 3 0 1 3 1 1 2 1 0 2 3 3 2 0 2 0 1 0 0
1221320113230122201101100
1003002333100121100023002
2 3 2 2 3 2 1 2 3 2 2 1 0 2 0 3 1 1 0 0 3 1 0 0 2
0 0 0 2 2 0 1 1 1 1 1 0 1 1 2 0 2 0 2 1 0 0 1 1 2
0011110100100111111011010
