0  2  1  2  3  0  2  0  1  3  1  1  3  0  3  0  3  1  2  2  3  2  0  3  1  2  2  1  0  2  1  3  1  2  2  1  2  2  0
0 3 2 1 2 3 3 2 1 3 2 1 1 3 0 3 0 1 2 1 1 2 2 3 2 0 3 0 2 3 3 1 0 3 3 2 2 2 2
031221022123131210331010120213103021030
1 1 1 3 3 3 0 2 1 0 3 2 1 2 1 1 0 0 0 3 2 2 0 3 0 0 3 1 1 2 0 0 2 1 1 2 1 2 2
3  2  1  1  1  1  3  2  3  3  2  1  0  2  2  3  2  1  2  3  0  1  2  3  0  1  0  2  2  1  1  2  3  3  1  1  2  3  0
0 3 0 0 3 2 0 2 3 3 0 0 0 2 1 2 0 3 0 1 0 3 0 1 0 2 1 0 3 3 0 1 1 1 2 1 1 0 2
3  2  2  1  0  3  2  2  1  0  3  2  3  2  0  0  3  0  1  1  0  2  0  1  3  3  3  2  0  0  0  2  0  2  0  2  3  1  2
1 3 0 2 3 0 3 3 2 0 2 3 3 3 1 2 1 3 1 3 2 0 2 1 2 0 1 2 2 2 1 3 2 0 0 0 1 2 2
203001032121033102200133313311100303102
3  0  2  3  3  3  3  3  1  2  0  0  2  2  3  3  0  2  0  1  2  0  1  0  3  2  2  0  2  3  0  2  2  3  3  1  0  2  2
313212112313303031321231210330302122310
231100311321223210331331201131002300000
0 2 3 3 2 1 1 2 3 2 2 3 1 0 3 3 1 3 3 0 0 3 2 3 3 2 3 0 2 3 3 3 1 0 0 0 0 3 2
1 2 2 0 0 0 0 0 0 0 2 1 0 3 0 2 2 3 1 1 2 0 3 2 1 0 1 3 2 1 2 0 1 0 0 3 0 1 2
3 2 1 2 0 3 1 2 3 1 1 2 0 3 3 1 3 0 0 0 3 1 3 3 1 1 0 1 1 3 3 0 0 2 2 0 2 2 2
0 1 2 3 1 0 1 0 1 2 2 0 2 3 0 1 3 1 2 3 1 1 1 2 3 1 2 1 0 3 1 0 1 0 3 3 0 0 0
0  0  2  1  2  1  1  2  1  3  1  1  0  2  0  1  1  3  3  3  3  0  1  0  3  2  0  3  3  0  0  3  1  1  3  3  0  0  0
0  3  0  3  2  2  0  3  3  1  1  0  3  3  3  1  1  3  2  0  1  1  0  2  2  3  3  0  2  0  2  1  0  3  3  1  1  3  2
202033033333003323121132012122001312300
1  3  0  2  3  3  3  2  1  1  2  3  1  1  0  1  1  3  1  2  1  0  3  3  2  1  1  2  2  2  3  0  3  2  3  2  2  3  2
300300303323113132200010113020030011302
312002103003311023223103233122110230310
0  3  3  2  3  2  0  0  3  2  3  0  0  2  1  3  0  3  2  1  1  3  1  3  3  2  3  1  1  1  1  0  0  0  1  3  1  3  0
113113123021000112021033323323320120222
302222013022133033132211321213101103112
3  3  3  3  1  1  0  2  1  2  0  2  0  3  0  0  0  3  0  0  0  2  1  1  2  2  3  2  3  0  2  1  3  2  2  1  2  0  2
0  1  1  1  0  0  0  0  0  0  1  0  1  1  0  0  1  0  0  1  1  0  0  1  1  1  1  0  0  0  0  1  0  0  0  1  1  0  0
