212113210
0  1  0  0  1  1  0  3  0
2 3 1 1 1 3 0 3 0
321203202
100220122
232021300
1 0 2 1 1 2 1 0 2
003303100
1  1  2  2  0  0  2  1  2
1 3 2 0 1 2 3 0 2
0 1 1 0 0 0 1 0 0
