0 1 0 0 3 0 3 1 1 1 0 0 1 3 3 2 3 2 2 2
3  1  1  2  1  3  2  3  1  3  2  3  2  2  0  2  1  1  1  0
0 0 1 3 1 3 1 1 2 0 2 0 3 0 0 2 3 2 0 2
12111113303203320030
1 3 1 0 1 2 0 0 2 2 1 2 3 0 1 3 1 3 0 0
01031113003113031332
22332220302110322332
23013322120101202010
13112200023123111030
0  1  3  1  2  1  3  2  0  1  2  1  1  3  3  3  2  3  3  0
31303222333221231112
0 3 3 0 0 3 0 3 0 3 0 2 1 0 0 1 0 3 1 2
2  0  2  0  3  3  3  1  3  3  1  2  2  0  3  3  3  1  1  2
3  1  3  1  2  3  3  2  1  3  2  2  2  2  1  1  3  0  2  0
10113223133233301302
00032030320133030302
3  2  0  2  1  3  2  0  3  2  0  2  3  0  1  0  1  2  3  2
0  1  0  0  1  1  0  1  0  0  1  3  3  2  1  0  2  2  2  2
0 1 1 1 1 0 0 1 0 1 1 0 0 0 1 0 0 1 1 0
