0 2 2 2 0 2 1 0 3 2 0 0 0 0 2 3 0 0 3 1 3 1 2 1 2 3 2 1 2 2 0 2 0 1 2 3 2 0 1 1 0
30311130003121111202030032313320000200012
23133310221132330032300010031102200221312
1 2 2 1 3 3 0 2 3 3 3 0 3 0 3 2 0 0 0 1 1 1 2 0 1 2 0 1 0 2 0 1 3 0 3 2 2 0 3 1 0
1  3  0  2  3  3  1  3  3  2  2  0  3  1  0  1  2  2  1  1  0  0  2  1  0  0  2  0  0  2  2  0  0  1  2  1  2  2  2  1  2
0  1  3  0  0  1  1  2  3  2  2  3  3  3  2  0  2  2  0  1  3  1  1  3  1  2  1  0  0  2  1  2  0  0  1  0  2  2  1  2  0
0  3  3  2  3  1  2  2  3  2  1  1  3  2  1  0  0  3  0  1  0  3  2  3  0  2  2  0  0  2  2  2  0  0  2  2  1  1  0  3  2
33301100032023322333122122223100211303010
03231322130030301211121013122031031103220
2  2  3  1  0  2  2  2  2  1  0  1  1  2  0  0  2  0  1  0  2  2  3  2  1  2  1  3  3  2  0  0  3  1  1  2  2  0  1  3  2
2 0 3 0 2 0 0 0 0 1 3 0 3 3 2 0 2 2 1 0 2 1 0 0 3 3 3 2 3 2 2 0 0 1 1 3 2 2 2 2 2
0  1  1  1  3  3  3  1  1  2  0  2  2  1  0  0  0  1  2  1  1  2  0  2  3  3  1  1  3  2  3  1  3  0  0  0  0  1  2  2  2
3 0 1 2 1 1 0 2 0 3 2 0 3 3 2 3 0 0 2 2 2 1 3 0 0 2 1 2 1 3 3 3 3 3 3 1 2 1 1 3 0
3 0 2 2 1 0 0 0 1 1 3 2 2 0 3 0 2 3 2 3 1 2 0 2 0 0 1 2 1 0 0 1 0 1 2 0 0 0 2 0 0
13212111012031232033322031100010303220300
1  1  1  2  0  0  2  3  0  2  3  2  0  0  3  2  2  3  2  1  2  2  3  3  2  2  1  2  1  1  0  2  3  1  0  2  2  3  1  1  2
11310110011320310102123003033200323102302
3 2 0 0 0 0 1 3 2 3 0 0 3 0 1 2 0 1 1 1 1 1 3 1 0 3 3 2 1 2 0 2 0 1 2 0 2 0 3 3 0
2 1 2 1 3 1 1 3 2 2 3 3 0 3 1 1 3 2 1 3 1 3 0 3 2 1 0 0 1 0 1 3 3 1 0 2 3 3 3 1 2
1 1 1 1 0 1 1 1 0 0 1 1 0 1 0 1 1 0 1 0 0 1 0 1 0 1 1 0 0 1 1 0 0 0 1 1 1 0 1 1 0
