31330330202310020312213100300311222020230
2 1 1 2 2 1 2 2 0 3 1 0 2 3 2 1 1 3 0 0 1 1 1 0 1 1 1 3 2 1 2 2 2 1 0 3 3 2 3 3 0
2 3 1 3 3 0 1 0 0 2 3 0 0 1 1 3 0 3 0 0 2 1 1 0 0 1 3 1 1 3 3 0 2 2 3 3 1 1 1 2 0
0  0  0  3  1  1  2  1  3  3  2  2  0  0  1  3  3  0  2  0  1  0  0  1  2  3  3  2  3  2  0  3  0  3  2  1  3  2  2  3  2
0 0 2 2 2 2 2 0 0 1 1 3 2 1 0 1 3 3 1 1 2 0 2 0 0 3 1 0 2 2 2 3 3 0 1 0 1 0 2 3 2
1 2 2 1 1 1 3 0 0 2 1 1 1 0 2 2 2 0 1 2 2 1 3 3 3 2 2 3 0 2 3 3 2 1 0 1 3 1 3 3 2
03101202000000333033101203023132003230332
2 0 0 3 1 2 2 2 1 1 0 0 0 0 0 0 3 3 2 3 0 0 2 0 0 2 2 0 3 1 3 2 2 2 3 3 3 2 2 1 0
21030031230010031103302121221233010201210
2  2  1  3  1  2  0  3  1  2  3  1  2  0  1  1  1  3  1  1  3  0  0  1  1  1  1  3  0  1  3  3  2  3  3  1  2  3  0  2  0
0 3 2 2 3 1 1 2 3 2 0 1 3 2 1 3 3 0 1 1 2 3 3 0 3 0 1 3 2 3 3 0 3 0 0 3 2 0 3 1 2
01102133321323032111113020211012012103002
31221301001020210003123001211331103130120
1 1 0 2 1 1 3 2 2 1 2 2 0 0 0 0 3 3 0 2 1 1 0 3 0 0 3 1 1 0 1 1 2 0 0 1 1 0 3 1 0
3  3  3  2  1  2  2  1  0  1  1  1  2  3  3  3  2  1  3  2  2  0  0  2  1  2  1  3  1  0  3  0  1  3  3  0  0  2  0  0  0
3 0 3 0 3 2 3 2 1 3 3 2 0 1 3 1 3 2 1 2 2 0 1 3 3 3 0 2 2 2 2 2 2 3 3 1 0 2 2 0 2
01033003200123130201213102130302311310202
1  2  1  2  1  1  0  2  0  3  3  1  0  2  1  3  1  3  3  3  3  0  3  1  3  0  1  2  3  1  2  2  3  1  0  2  0  3  2  3  0
1 2 3 0 0 1 0 1 0 1 2 2 0 0 2 2 0 1 0 3 2 1 1 1 0 1 0 2 2 0 3 3 3 3 2 1 2 0 1 2 2
02103131321332332220313210330321023121030
33232303220112232000213323202120110102122
2 3 0 1 3 1 3 0 1 0 0 0 1 2 0 2 3 2 2 0 1 3 0 3 3 3 0 3 0 2 1 1 1 2 3 0 3 1 2 3 2
0 1 1 2 3 0 3 1 2 2 3 2 3 0 1 0 2 3 3 2 2 1 3 2 0 1 1 3 1 0 2 1 3 1 1 0 2 1 2 2 2
30000112122300333033220020101001231112020
21033201313301011220220101121301120333300
3 1 2 0 2 1 0 1 3 3 2 3 0 3 1 3 0 0 1 0 1 3 3 0 2 0 1 0 2 2 3 1 2 1 3 2 2 2 1 3 2
1 0 1 0 1 0 0 0 0 1 1 0 1 0 0 1 1 0 0 0 0 0 0 0 1 1 0 0 1 0 1 0 1 1 1 1 0 1 0 1 0
