202233210111132121331033322113012132300
0  2  3  0  0  3  1  2  2  2  2  2  3  3  3  1  0  3  2  2  1  2  0  3  1  0  1  1  2  1  2  0  0  3  3  1  3  1  0
313102120100212113011133323113332213302
0 1 0 2 3 0 0 1 3 1 0 0 0 0 0 1 3 1 3 0 1 0 0 0 1 1 1 2 1 0 3 0 2 2 1 1 3 3 0
2  3  3  3  1  0  2  1  3  0  0  0  1  3  3  3  0  0  2  2  3  3  3  2  3  1  1  3  0  3  0  0  0  2  2  1  2  2  0
2 2 0 0 1 0 0 3 2 0 0 0 1 3 3 0 0 0 1 3 1 2 3 3 1 1 3 0 1 2 0 2 2 1 1 0 0 2 2
2 1 2 1 2 3 3 3 0 1 2 3 0 0 0 0 0 1 0 1 0 1 3 3 2 3 3 3 3 2 1 1 1 2 0 2 3 1 2
110011000101011111101011111100101000000
