2  1  1  1  3  2  0  1  0  2  1  3  0  3  3  2  2  3  1  1  3  2  1  2  0  3  3  0  0  0  1  0  2  3  2  0  1  1  3  2
3321201213201221123221101130013321013320
1 3 3 1 3 3 2 3 0 0 2 1 1 3 2 1 2 2 1 3 1 1 2 2 2 3 2 1 1 0 2 0 3 1 0 3 3 2 2 2
1233101202033200313112313022330100013010
2 3 3 2 0 2 2 0 1 2 1 3 3 2 2 1 0 2 2 2 3 3 1 3 1 3 0 1 2 0 1 1 2 0 1 3 1 2 1 2
2 3 0 3 1 2 2 2 2 2 3 0 0 1 0 0 0 3 2 0 2 3 2 0 3 3 3 0 1 3 1 3 2 2 3 3 0 1 0 2
0  0  0  1  0  3  3  0  2  1  2  1  1  2  2  0  1  0  2  1  1  2  3  0  3  0  3  2  2  0  1  0  0  3  0  3  1  2  0  0
2312212112333112220131230301000012320110
3 2 1 0 1 3 0 3 1 0 2 2 1 2 0 2 3 2 0 3 1 1 2 3 1 1 0 3 2 2 1 2 1 0 1 0 0 2 3 0
3  1  2  0  2  3  3  0  2  3  0  1  1  3  1  1  2  0  1  0  3  2  1  1  3  2  1  0  2  0  3  1  2  2  3  1  1  2  2  0
2  3  2  1  2  3  3  2  1  2  1  2  1  3  2  2  2  3  2  1  1  1  2  3  2  3  3  0  0  1  0  3  0  3  0  0  2  0  2  0
1120311021203332311301311222003003211330
2111121312031002012202223320312011313202
0  2  2  0  3  3  3  2  0  3  3  0  2  0  1  2  1  0  3  2  3  2  3  2  2  0  2  3  3  3  2  1  2  2  1  1  3  2  0  0
2303301332030123300213003200213010023222
1312301031113323131200320102221110123212
1 2 2 0 1 1 1 2 2 0 0 2 0 2 2 0 1 2 0 3 2 2 2 3 1 2 3 2 1 3 3 3 1 3 2 3 2 1 0 2
0  3  3  3  0  0  0  3  1  2  1  3  3  2  1  3  0  3  3  2  1  0  3  2  2  3  2  3  1  0  2  3  0  2  0  0  0  1  0  0
1 1 1 3 3 0 1 2 3 1 3 1 2 3 1 1 1 0 0 1 1 3 1 0 2 1 2 0 2 2 2 1 1 3 2 0 1 3 1 2
2  0  3  0  2  3  1  1  1  3  2  0  0  2  3  0  2  3  1  2  2  2  1  3  1  2  2  1  2  3  2  1  0  1  3  3  2  3  2  0
3011110103230220022330301121222033312300
2123330012111110030233101101111233112302
3  1  1  1  2  3  0  3  0  1  3  2  1  2  3  0  1  2  2  2  0  3  3  2  0  1  3  0  0  3  0  3  3  2  3  3  1  2  1  0
3121110311320223121211012000132000232202
1  0  1  0  1  1  0  0  1  1  0  0  0  0  0  0  0  1  1  0  0  1  1  0  0  0  1  0  0  1  0  1  1  1  0  1  0  1  1  0
