0  3  1  3  3  1  2  0  3  1  3  2  3  1  2
030303203113212
2  1  2  3  3  2  0  2  0  3  0  0  1  1  2
3  2  3  0  2  1  3  3  1  2  2  0  3  2  2
200113022030010
322331131321302
1 3 0 2 0 1 0 1 0 1 0 2 3 3 2
012003332233010
0  2  2  1  0  3  1  3  1  2  3  2  2  1  2
1  3  2  1  3  0  2  2  1  3  1  1  3  1  0
302233231230300
331012121113120
3  3  0  1  0  3  3  1  2  2  1  2  2  3  2
2  1  3  1  0  1  0  0  2  3  3  1  3  3  0
123112031310022
000111000001110
