3 1 1 0 1 3 0 0 2 2 2 2 2 0 0 0 2
0  0  3  2  1  3  2  0  2  0  3  0  2  2  1  2  2
3  2  2  3  0  2  3  1  0  3  1  0  3  0  0  2  0
3  3  0  1  0  0  1  1  1  1  2  0  3  1  2  0  2
1 2 1 2 1 3 3 2 1 1 0 1 3 2 2 3 2
0  2  3  2  3  0  2  3  0  2  2  1  2  1  2  2  0
0 0 3 2 0 3 3 3 3 2 3 0 0 2 0 0 0
0 0 0 0 2 0 0 2 0 2 3 0 1 2 3 1 0
2  1  1  1  1  0  1  2  3  3  1  3  0  2  1  0  0
31230110221220210
21213013133301102
3 3 1 3 3 3 3 1 1 0 2 1 2 2 1 2 0
2  0  2  3  1  3  0  0  0  1  2  0  0  1  3  0  2
31021110323100010
02323111202330000
00020033331232222
0  2  0  0  0  0  0  3  1  0  1  1  1  0  0  1  0
3  3  3  2  1  2  1  3  1  3  1  0  0  3  1  2  2
3 0 0 1 0 1 3 1 0 2 0 3 0 3 0 2 0
3  1  1  0  1  1  1  3  0  2  2  1  1  0  2  2  2
2 3 3 1 1 0 1 3 3 3 2 0 1 1 2 3 0
2  2  2  3  1  3  3  1  1  1  3  0  3  0  0  3  0
32301023111300130
33313302113312012
1 0 2 2 3 3 0 0 2 1 3 3 0 3 2 2 2
2 3 3 0 3 1 3 3 2 3 2 0 1 3 3 3 0
10110111001111110
