1232321313220222021123332300223120120320
0200130023002111322131222102221101102020
1003011021311322211310011002301301321330
2121130103232022320223033122113131301210
2203121000000311101213220230020102023220
1033330120202022021221020130210322003232
0 1 0 3 2 0 3 0 3 2 2 2 3 3 3 2 2 2 0 2 3 0 0 1 0 2 3 3 0 1 3 1 2 0 1 0 1 0 3 0
3 0 1 1 3 2 0 0 1 2 3 3 1 1 1 1 0 0 1 0 2 1 1 3 3 3 1 0 1 2 3 1 1 3 2 3 1 1 3 0
2012100033012120220022303320331022212312
2  0  0  2  2  2  2  3  1  1  1  3  3  3  2  0  1  3  2  1  2  2  3  3  2  1  1  0  1  0  2  3  1  0  3  3  0  0  2  0
2 3 0 0 3 2 2 1 3 1 0 2 0 1 0 3 1 3 0 2 0 3 2 1 1 1 3 2 0 0 3 3 0 3 1 2 1 0 3 2
2  2  3  2  1  2  1  2  1  0  0  2  1  2  1  1  1  1  1  3  2  0  2  3  2  0  3  0  0  1  1  3  1  0  2  3  2  0  3  2
3  1  3  3  1  1  2  3  2  3  2  1  2  0  1  1  1  3  1  0  3  2  2  2  3  2  1  2  3  3  2  3  0  3  2  1  3  3  1  0
0  1  0  1  1  0  0  1  1  0  1  0  1  0  0  0  1  1  0  1  1  0  0  0  0  1  0  1  1  1  1  0  0  1  0  1  1  1  0  0
