12011111132100210121201003233013130230212
0  0  1  2  3  2  1  1  0  2  0  3  0  1  3  1  2  1  3  2  1  0  2  3  0  3  1  0  3  0  3  3  0  2  0  3  2  3  0  1  2
2  1  0  3  1  2  2  1  0  0  3  1  2  1  0  0  2  0  3  0  3  3  3  1  3  2  2  0  3  2  3  1  1  0  2  2  3  1  3  3  2
2 3 2 0 1 2 0 3 1 2 0 1 0 1 1 3 3 1 3 3 3 0 0 1 1 2 1 2 2 0 0 0 3 3 3 3 3 3 3 1 2
03300333121310222230330220112213222222002
1 0 2 3 3 2 1 1 0 2 2 0 3 3 0 3 1 3 0 0 1 0 2 3 1 3 2 0 0 2 2 2 3 2 3 3 1 2 2 3 2
3 1 2 3 1 3 2 1 3 1 2 3 2 3 3 2 2 2 3 2 1 0 3 3 1 0 0 2 0 1 3 1 0 3 2 2 3 1 0 2 0
20131333311031020332131211021312222101312
10220233202230122012301032031230301311010
10230200301022202103222323322222230002112
0  0  3  0  3  3  1  2  2  0  3  2  1  1  1  0  1  0  3  0  1  1  1  1  1  2  1  1  3  0  2  1  3  0  1  0  1  2  2  3  0
0  0  0  0  0  0  1  0  1  0  0  0  0  0  0  1  1  0  1  0  1  1  1  0  1  0  1  0  1  1  1  0  0  0  0  1  0  0  0  0  0
