1  0  2  0  2  2  2  2  1  0  1  0  2  1  1  3  2  0  1  2  0  1  1  2  0  0  3  1  3  1  2  1  2  3  3  1  0
3103001323032330300310210121323033002
0 3 0 3 1 3 3 1 1 1 0 0 2 3 0 2 1 0 0 0 2 1 3 2 2 0 0 3 0 0 0 1 2 3 3 3 0
1202012313313232311201221232101330130
2 3 0 2 1 0 3 3 3 1 3 0 2 1 0 3 2 2 0 3 0 3 1 0 1 2 1 2 2 1 3 1 1 3 1 1 2
2002321122333231133023022232032232312
1 3 1 2 1 1 2 1 3 0 0 3 2 2 0 0 2 3 0 3 1 2 1 1 2 0 1 1 1 3 0 0 2 2 2 1 0
3  3  3  0  0  1  2  1  0  3  1  1  1  2  0  3  3  0  1  2  3  0  1  3  2  2  3  2  3  3  1  0  3  2  2  2  0
2 0 1 3 2 2 3 3 0 1 3 3 3 0 1 2 1 0 1 0 1 0 2 0 3 3 2 0 2 0 1 2 3 1 1 0 2
3  2  2  3  0  1  1  3  0  0  0  3  1  0  3  1  0  1  0  2  0  3  2  1  1  3  2  0  0  0  0  2  3  0  3  3  0
3110033313103132323110103030130020122
3032020111023321221101312232330110120
0  2  1  1  1  2  2  1  0  2  1  3  3  1  2  0  3  3  0  2  2  0  0  2  0  2  2  0  0  3  3  3  1  0  0  0  2
2 3 1 1 3 0 2 0 1 0 1 1 3 3 0 1 1 1 3 3 0 3 1 3 0 3 1 2 0 2 2 0 3 1 3 2 0
1  2  2  1  1  1  0  3  2  3  0  3  3  3  2  3  3  0  1  1  3  3  1  1  3  0  2  0  3  2  3  3  0  3  0  0  0
2  0  3  0  3  2  0  1  1  2  1  1  1  0  1  1  3  0  1  2  3  0  1  2  3  0  2  3  1  0  2  1  0  3  2  2  0
3112001012212013301322230333222212202
1110011101110001111011100101000100000
