0  2  1  2  2  1  0  3  2  1  0  3  3  0  0  2  3  3  3  0  2  1  2  3  2  1  1  2  1  2  0  2  1  2  3  2  2  2
31103221212111311201303023211230022330
33201021333003013032321113331120000220
3 0 2 2 0 0 2 2 2 0 1 1 2 0 3 3 0 2 0 2 3 1 0 1 1 2 0 2 0 2 1 1 0 2 1 3 1 2
2  2  3  2  0  3  3  3  2  0  3  2  3  0  2  2  2  1  3  0  1  0  0  3  0  0  3  2  0  3  1  3  2  0  0  2  2  2
2 1 0 0 3 1 0 0 1 1 2 3 2 2 0 0 3 2 0 1 2 0 2 3 0 0 3 3 2 1 1 3 2 3 2 3 2 0
0 1 3 0 0 0 2 2 2 0 0 0 1 1 2 2 2 3 0 2 3 3 0 2 3 0 0 3 0 0 0 1 0 0 0 1 3 0
2 2 0 1 2 0 3 1 0 0 1 2 1 2 1 2 2 1 2 1 3 0 3 1 1 1 1 0 1 3 2 0 3 3 1 0 3 2
0  1  1  1  0  3  0  0  0  0  0  0  0  0  3  2  1  0  1  3  3  2  0  0  1  0  2  1  1  0  0  3  1  2  1  0  0  2
3  3  1  2  2  0  3  1  2  0  1  2  0  2  2  2  1  2  1  0  1  0  1  3  3  2  3  2  2  0  1  3  1  2  0  0  3  2
0 1 3 0 1 1 3 3 1 1 3 0 0 3 1 3 1 2 2 2 2 1 1 2 3 2 1 3 0 1 1 2 0 1 3 0 3 0
2  0  2  3  2  1  1  3  0  0  1  3  0  1  3  1  1  1  1  3  3  3  2  2  3  3  0  2  1  2  3  2  2  2  3  0  1  0
02110220011212320010003222321032211300
0 2 0 0 1 2 3 1 3 1 2 0 2 1 3 3 3 0 0 0 1 3 1 2 0 2 1 0 3 0 2 3 3 3 1 2 0 2
2 0 3 3 3 1 1 1 3 0 0 1 3 2 0 1 3 2 3 1 2 2 3 2 2 0 0 1 3 2 1 0 0 1 2 1 3 2
23030321032230231212213322121232031230
3  3  0  3  2  0  1  3  1  2  3  0  3  1  2  1  3  1  0  3  0  0  0  3  1  2  0  1  3  3  2  1  1  0  2  0  2  0
3 3 2 3 2 0 1 2 1 3 1 2 2 0 1 3 1 1 0 0 1 3 2 0 2 0 2 1 0 2 3 0 2 3 2 3 3 0
0 0 1 3 2 3 3 1 1 2 0 2 1 0 1 0 1 3 1 1 0 1 2 1 2 3 1 2 2 3 2 3 0 2 0 3 1 0
2  1  0  1  3  3  2  0  1  3  2  2  0  2  3  0  1  3  0  2  2  2  2  0  0  3  3  3  1  2  1  3  3  3  1  2  3  0
12300303303201311011010130311012331010
00111011001001100001100000010000001110
