0 0 0 1 0 0 3 2 1 1 0 0 3 3 3 2 2 1 2 2 1 0 0 0 0 2 1 3 3 2 0
0 2 1 2 3 1 0 2 1 2 3 3 2 0 0 3 2 1 1 1 2 3 2 0 0 1 1 3 0 1 2
1  0  0  2  3  1  3  0  3  3  3  3  3  3  3  3  3  3  0  3  0  1  3  2  2  3  1  1  3  2  2
2123010120121231101232223112132
1233302303202201100330202202232
2  2  2  1  2  1  0  1  3  1  2  0  2  3  0  1  1  3  1  2  0  0  2  0  0  1  2  3  2  0  0
2 1 2 0 3 2 2 0 1 0 0 0 0 0 3 2 0 1 2 3 2 3 2 0 0 1 0 3 3 0 2
2021132330223202003100100012310
0231313230310331203223033021230
2  0  0  2  3  3  0  2  3  3  3  1  2  3  3  3  2  2  0  3  3  1  0  2  1  2  3  0  1  3  0
0 2 1 3 0 1 3 3 2 0 3 0 2 2 1 3 2 3 3 0 2 1 2 2 0 3 0 0 1 2 2
2  2  1  2  2  2  2  0  3  2  3  2  2  2  0  1  1  2  3  3  1  1  3  1  3  1  1  3  2  2  2
3 3 3 3 2 0 0 0 0 3 1 2 3 1 2 0 2 1 3 3 2 0 1 2 0 0 1 0 0 2 2
1  3  0  1  2  3  0  3  2  1  3  0  3  3  1  2  3  2  0  1  1  2  0  2  0  3  0  0  2  0  2
0  3  2  2  3  1  3  0  3  0  1  0  3  2  2  1  3  1  2  0  2  0  1  3  0  0  1  1  0  3  2
2 3 2 0 3 2 0 1 3 3 1 2 2 3 1 2 3 2 0 3 0 0 2 3 1 1 0 1 3 3 0
0  0  2  1  0  2  1  2  3  3  0  2  1  1  3  2  2  1  3  1  2  1  3  1  0  3  0  2  1  0  2
1  1  1  3  1  3  1  1  2  1  2  3  0  1  2  1  1  2  3  2  3  3  0  1  0  0  3  1  0  2  0
0320321330022233130001103120330
3  2  2  2  1  2  3  3  3  2  2  1  2  2  0  3  1  3  3  3  1  3  2  1  1  1  0  3  3  1  2
3 1 3 3 1 2 3 1 2 3 1 0 1 0 3 2 2 0 1 1 2 3 0 1 0 1 2 3 2 1 2
2200212200322112302213011323330
0  2  2  1  1  2  2  2  0  0  0  3  2  2  0  2  2  3  1  1  0  1  3  3  2  1  1  3  3  2  2
2 1 3 2 0 3 1 3 3 2 0 0 3 0 2 1 3 0 1 1 2 2 2 3 1 1 3 3 0 3 0
0123021323121211333032023313132
0  1  1  0  1  0  0  0  1  1  1  0  1  1  0  0  0  0  0  0  0  1  1  0  0  1  1  1  1  1  0
