0 3 3 2 3 2 2 2
2 0 3 2 0 0 0 2
2 3 2 0 0 1 1 2
0 1 2 3 1 1 1 0
3 3 3 2 2 3 2 2
1 0 2 2 3 2 0 2
3 0 2 2 2 3 0 2
31002300
2  2  0  1  2  1  2  2
3 0 2 0 0 0 1 0
0  1  3  0  3  0  3  0
01232032
13331012
1 1 0 1 3 0 0 2
2 3 1 0 3 3 2 0
1 0 1 0 0 3 2 0
2 1 2 3 1 0 2 2
00310230
23133302
30220220
11121332
3 3 0 0 1 2 3 2
01111110
