1  0  2  1  0  2  2  0  1  2  0  1  2  2  1  0  1  3  2  0  3  3  0  0
313003223320333223023130
321222113103133312330300
211132332021201030113120
2  2  2  0  2  1  0  0  2  3  0  1  2  2  2  3  2  3  0  1  1  0  2  0
3 1 3 3 1 1 0 3 2 2 3 1 1 1 0 1 3 2 0 1 0 3 3 2
2  0  0  3  1  0  0  1  3  1  2  0  2  2  0  0  3  1  0  2  1  0  3  0
2 3 3 3 1 1 1 3 1 3 0 2 1 3 3 1 0 3 3 2 1 3 2 2
3  3  2  0  3  1  1  2  1  2  2  2  3  1  3  1  2  0  0  0  2  2  1  0
3 3 2 1 2 2 3 2 0 2 3 1 1 2 2 2 1 3 0 1 2 0 1 0
210110130110000131103232
2  0  2  0  1  3  3  3  2  3  3  1  0  0  1  1  0  0  0  2  0  2  1  0
1  0  3  0  2  1  1  0  0  3  2  0  0  1  2  3  3  0  0  1  2  2  1  2
1 1 1 0 2 2 1 3 0 3 3 2 0 0 3 2 2 2 2 3 3 1 3 2
120122302033011333123230
012302310321301302321022
1 0 2 0 1 0 3 3 0 3 2 0 1 2 0 1 2 3 3 2 3 1 0 0
0  1  1  2  3  3  3  3  1  0  0  0  0  0  1  0  1  1  0  1  3  2  3  2
201210221033011022220132
0 2 0 0 3 3 1 0 0 1 3 3 2 2 1 0 0 0 1 1 1 2 1 0
000130200101113201221030
3 0 0 0 1 1 3 0 2 0 2 2 1 0 2 2 0 1 3 2 1 3 0 0
022303002210231103133220
230233302021202231021222
220222131012203021211200
2 2 2 0 1 0 3 2 0 3 2 3 0 3 0 0 2 2 1 1 1 3 2 2
1  2  1  1  0  2  0  3  1  0  1  3  2  3  0  3  2  1  2  3  0  3  0  0
222130000001120302133300
1 0 0 0 3 2 0 3 2 2 1 3 2 3 1 1 1 1 1 0 1 0 1 0
1 3 3 0 0 0 1 3 0 2 3 2 2 3 1 2 1 3 2 3 3 3 0 2
1 0 0 0 1 0 1 1 1 1 0 1 1 0 0 1 0 1 0 0 0 0 1 0
